Language ISO	Territory ISO	LanguageFormedInThisRegion	TimeLanguageAntecedentsEstablishedBefore1500
eng	AC	0	0
cat	AD	1	1
fra	AD	0	1
spa	AD	0	1
ara	AE	1	1
bal	AE		
eng	AE	0	0
fas	AE	0	1
fra	AE	0	1
mal	AE		
pus	AE		
ssh	AE	1	1
abh	AF	1	1
aee	AF		
afg	AF		
aiq	AF		
ara	AF	0	1
ask	AF		
bal	AF		
bgn	AF		
brh	AF		
bsh	AF		
eng	AF	0	0
fas	AF	0	1
gju	AF		
glh	AF		
gwt	AF		
haz	AF		
isk	AF		
jat	AF		
kaa	AF	0	1
kaz	AF	0	1
kir	AF	0	1
lah	AF		
mhj	AF		
mnj	AF		
nli	AF		
oru	AF		
paq	AF		
pbt	AF		
pbu	AF		
phv	AF		
prc	AF		
prd	AF		
prn	AF		
prs	AF	1	1
psh	AF		
psi	AF		
pus	AF	1	1
raj	AF		
sdg	AF		
sgh	AF		
sgy	AF		
sts	AF		
tra	AF		
trm	AF		
tuk	AF	1	1
uig	AF	0	1
urd	AF		
uzb	AF	1	1
uzs	AF	1	1
wbk	AF		
wbl	AF		
wrd	AF		
wsv	AF		
xbc	AF		
xvi	AF		
aig	AG		
eng	AG	0	0
por	AG		
eng	AI	0	0
spa	AI	0	0
als	AL		
ell	AL		
fra	AL	0	0
mkd	AL		
rom	AL	0	1
rup	AL		
sqi	AL		
sqk	AL		
aen	AM		
aii	AM	0	1
axm	AM		
aze	AM	1	1
bel	AM		
deu	AM		
ell	AM		
eng	AM	0	0
fas	AM	0	1
fra	AM	0	0
hin	AM		
hye	AM		
hyw	AM		
kat	AM		
kmr	AM		
kur	AM		
pol	AM		
rmi	AM		
rom	AM	0	1
rus	AM		
spa	AM	0	0
syr	AM	0	1
tur	AM	0	1
ukr	AM		
xcl	AM		
blv	AO		
cjk	AO		
dhm	AO		
hng	AO		
hol	AO		
khu	AO		
kmb	AO		
knw	AO		
kon	AO		
kwy	AO		
kwz	AO		
lch	AO		
lin	AO		
lum	AO		
mck	AO		
mfu	AO		
mxg	AO		
nba	AO		
ndq	AO		
nkn	AO		
nne	AO		
nql	AO		
nsx	AO		
nye	AO		
nyk	AO		
olu	AO		
pnd	AO		
por	AO	0	0
umb	AO	1	1
xdo	AO		
yax	AO		
aed	AR		
arn	AR	1	1
axb	AR		
calc1235	AR		
crq	AR		
crt	AR		
cym	AR		
eng	AR	0	0
grn	AR		
moc	AR		
mzh	AR		
ona	AR		
plg	AR		
pue	AR		
que	AR		
quh	AR		
qus	AR		
spa	AR	0	0
teh	AR		
tob	AR		
ule	AR		
vil	AR		
wlv	AR		
eng	AS	0	0
smo	AS		
ton	AS		
asq	AT		
bar	AT		
bos	AT		
ckm	AT		
deu	AT		
eng	AT	0	0
fra	AT	0	0
hbs	AT		
hrv	AT		
hun	AT		
ita	AT		
nrc	AT		
pol	AT		
rom	AT	0	1
slv	AT		
sqi	AT		
srp	AT		
tur	AT	0	0
adg	AU		
adt	AU		
aea	AU		
aer	AU		
afr	AU	0	0
aid	AU		
ajn	AU	1	1
alh	AU		
aly	AU		
amg	AU		
amx	AU		
amy	AU		
amz	AU		
ant	AU		
aoi	AU		
ara	AU	0	0
ard	AU	1	1
are	AU	1	1
asf	AU	1	1
asw	AU		
avm	AU		
awg	AU		
awk	AU		
axe	AU		
axl	AU		
ayd	AU		
bcj	AU		
bck	AU		
bdy	AU		
ben	AU		
bia	AU		
bjb	AU		
bjy	AU		
bpl	AU		
bpt	AU		
bvr	AU		
bxi	AU		
bxj	AU		
bxn	AU		
bym	AU		
bzr	AU		
cld	AU	0	0
cmn	AU		
cnh	AU		
coa	AU	1	1
dax	AU		
dbl	AU		
dda	AU		
ddj	AU		
ddr	AU		
deu	AU		
dgn	AU		
dgt	AU		
dgw	AU		
dhg	AU		
dhl	AU		
dhr	AU		
dhu	AU		
dhx	AU		
dif	AU		
din	AU		
dja	AU	1	1
djb	AU		
djd	AU		
djf	AU		
dji	AU		
djj	AU		
djn	AU		
djr	AU		
djw	AU		
dmd	AU		
dmw	AU		
drl	AU		
dth	AU	1	1
dwu	AU		
dwy	AU		
dyb	AU		
dyd	AU		
dyn	AU		
dyy	AU		
dze	AU		
eaa	AU	1	1
ell	AU		
eng	AU	0	0
err	AU		
fas	AU	0	0
fij	AU	0	0
fil	AU	0	0
fln	AU		
fra	AU	0	0
gbb	AU		
gbd	AU		
gbu	AU	1	1
gbw	AU		
gcd	AU		
gdc	AU		
gdh	AU		
gdj	AU		
gdt	AU	1	1
ggd	AU		
gge	AU		
ggk	AU		
gia	AU		
gih	AU		
giy	AU		
gjm	AU		
gjr	AU		
gko	AU		
gll	AU		
gma	AU		
gmr	AU		
gni	AU		
gnl	AU		
gnn	AU		
gnr	AU		
grg	AU		
gtu	AU		
gudj1237	AU		
gue	AU		
guf	AU		
guj	AU		
gup	AU		
gvn	AU		
gvy	AU		
gwm	AU		
gwu	AU		
gww	AU		
gyd	AU		
gyf	AU		
gyy	AU		
haz	AU		
hbs	AU		
hif	AU		
hin	AU		
hmn	AU		
hnj	AU		
hrp	AU		
hrv	AU		
ibd	AU		
ihw	AU		
iin	AU		
ikr	AU		
ilg	AU		
ind	AU		
ita	AU		
jan	AU		
jao	AU		
jay	AU		
jbi	AU		
jbw	AU		
jig	AU		
jng	AU		
jpn	AU		
jui	AU		
kba	AU		
kbe	AU		
kda	AU		
kdd	AU		
kgl	AU		
kgs	AU		
khm	AU	0	0
kjn	AU		
kkp	AU		
kky	AU		
kld	AU		
kor	AU		
ktd	AU		
ktg	AU		
kux	AU		
kuy	AU		
kvs	AU		
lah	AU		
lby	AU		
lbz	AU		
lja	AU		
ljw	AU		
ljx	AU		
lkm	AU		
lku	AU		
llj	AU		
lmc	AU		
lnj	AU		
lnw	AU	1	1
lrg	AU		
mal	AU		
mec	AU		
mem	AU		
mep	AU		
mfr	AU		
mhg	AU		
mkd	AU		
mlt	AU	0	0
mpb	AU		
mpc	AU		
mph	AU		
mpj	AU		
mri	AU		
msa	AU		
mvl	AU		
mwf	AU		
mwp	AU		
nad	AU		
nam	AU		
nau	AU		
nay	AU		
nbj	AU		
nck	AU		
nep	AU		
ngk	AU		
nha	AU		
nhf	AU		
nid	AU		
nig	AU		
niu	AU		
nji	AU		
nju	AU		
nld	AU		
nlw	AU		
nly	AU		
nmp	AU		
nmv	AU		
nna	AU		
nnr	AU		
nnv	AU		
nny	AU		
nrk	AU		
nrl	AU		
nrx	AU		
ntg	AU	1	1
ntj	AU		
nug	AU		
nuy	AU		
nwg	AU	1	1
nwo	AU		
nxn	AU		
nyh	AU		
nys	AU		
nyt	AU		
nyv	AU		
nyx	AU		
okg	AU		
olk	AU		
pan	AU		
pes	AU		
pit	AU		
piu	AU		
pjt	AU		
pkn	AU		
pmd	AU		
pnj	AU		
pnv	AU		
pnw	AU		
pol	AU		
por	AU		
pti	AU		
rar	AU		
rbp	AU		
rit	AU		
rkw	AU		
rmb	AU		
rnr	AU		
rop	AU		
rrt	AU		
rsm	AU		
rtm	AU	0	0
rus	AU		
rxd	AU		
rxw	AU		
sin	AU		
smo	AU		
spa	AU	0	0
srp	AU		
syr	AU	0	0
tam	AU		
tbh	AU		
tcs	AU		
tel	AU		
tgl	AU		
tgz	AU		
tha	AU		
thd	AU		
tiw	AU		
tjj	AU		
tjp	AU		
tju	AU		
tjw	AU		
tkl	AU		
ton	AU		
tur	AU	0	0
tvl	AU		
typ	AU		
ugb	AU		
uky	AU		
ulk	AU		
umd	AU		
umg	AU		
ump	AU		
umr	AU		
ung	AU		
unn	AU		
urc	AU		
urd	AU		
urf	AU		
uwa	AU		
vie	AU	0	0
vka	AU		
vku	AU		
vma	AU		
vmb	AU		
vmi	AU		
vml	AU		
vmu	AU		
waq	AU		
wbp	AU		
wbt	AU		
wbv	AU		
wdj	AU	1	1
wdk	AU		
wdu	AU		
wdy	AU	1	1
weg	AU		
wga	AU		
wgg	AU		
wgu	AU		
wgy	AU		
wie	AU		
wif	AU		
wig	AU		
wih	AU		
wij	AU		
wik	AU		
wil	AU		
wim	AU		
wkr	AU		
wkw	AU		
wky	AU	1	1
wlg	AU		
wlu	AU		
wmb	AU		
wmi	AU		
wmt	AU		
wnd	AU		
wnm	AU		
wnn	AU		
wny	AU		
woa	AU		
wrb	AU		
wrg	AU		
wrh	AU		
wri	AU		
wrk	AU		
wrl	AU		
wrm	AU		
wro	AU		
wrr	AU		
wrw	AU		
wrz	AU		
wth	AU		
wua	AU		
wub	AU		
wur	AU		
wux	AU		
wwb	AU		
wwr	AU		
wxw	AU		
wyb	AU		
wyi	AU		
xbb	AU	1	1
xbd	AU		
xbe	AU		
xbg	AU		
xbj	AU		
xbp	AU		
xby	AU		
xda	AU		
xdk	AU		
xgd	AU		
xgg	AU		
xgi	AU	1	1
xgm	AU		
xgu	AU		
xgw	AU		
xjb	AU		
xjt	AU		
xmh	AU		
xmp	AU		
xmq	AU		
xmu	AU		
xmy	AU		
xni	AU		
xnk	AU	1	1
xnm	AU		
xnu	AU	1	1
xny	AU		
xpa	AU		
xpb	AU		
xpd	AU		
xpf	AU		
xph	AU		
xpj	AU		
xpl	AU		
xpt	AU		
xpv	AU		
xpw	AU		
xpx	AU		
xpz	AU		
xrd	AU		
xrg	AU	1	1
xru	AU		
xth	AU		
xtv	AU		
xud	AU		
xul	AU		
xun	AU		
xut	AU		
xwd	AU		
xwj	AU		
xwk	AU		
xwt	AU		
xww	AU		
xxm	AU		
xya	AU		
xyb	AU		
xyj	AU		
xyk	AU		
xyt	AU		
xyy	AU		
yda	AU		
yga	AU		
ygi	AU	1	1
ygs	AU		
ygu	AU		
yhs	AU		
yia	AU		
yii	AU		
yij	AU		
yil	AU		
ylr	AU		
ynd	AU		
yrm	AU		
yry	AU		
yty	AU	1	1
yub	AU		
yue	AU		
yulp1239	AU		
ywg	AU		
ywr	AU		
yww	AU		
yxa	AU		
yxg	AU		
yxl	AU		
yxm	AU		
yxu	AU		
yxy	AU		
yyr	AU		
zho	AU	0	0
zku	AU		
zma	AU		
zmc	AU		
zmd	AU		
zme	AU		
zmg	AU		
zmj	AU		
zmk	AU		
zml	AU		
zmm	AU		
zmr	AU		
zmt	AU		
zmu	AU		
zmv	AU		
zmy	AU		
znk	AU		
eng	AW	0	0
fra	AW	0	0
nld	AW		
pap	AW		
spa	AW	0	0
fin	AX		
swe	AX		
ava	AZ		
aze	AZ	1	1
azj	AZ	1	1
bdk	AZ		
hye	AZ		
kjj	AZ		
kmr	AZ		
kry	AZ		
kur	AZ		
rus	AZ		
tkr	AZ		
tly	AZ		
ttt	AZ		
tur	AZ	0	1
udi	AZ		
xag	AZ		
bos	BA		
eng	BA	0	0
fra	BA	0	0
hbs	BA		
hrv	BA		
srp	BA		
bjs	BB		
eng	BB	0	0
aml	BD	1	1
aot	BD		
ben	BD	1	1
bgr	BD		
bpy	BD		
ccp	BD		
cdz	BD	1	1
ckh	BD		
cnk	BD		
csh	BD		
ctg	BD		
ekl	BD	1	1
eng	BD	0	0
grt	BD		
haj	BD		
ins	BD		
kdq	BD		
kha	BD	1	1
kru	BD		
lus	BD		
lyg	BD	1	1
mef	BD	1	1
mjt	BD		
mjx	BD	1	1
mni	BD		
mro	BD		
mya	BD		
pbv	BD	1	1
pkh	BD		
rhg	BD		
ria	BD		
rki	BD		
rkt	BD	1	1
rmz	BD		
sat	BD	0	1
sdr	BD		
syl	BD		
tnv	BD		
tpe	BD		
trp	BD		
unr	BD	1	1
urd	BD		
usi	BD		
xtr	BD		
deu	BE		
eng	BE	0	1
fra	BE	0	1
nld	BE		
sfb	BE		
vgt	BE		
vls	BE		
wln	BE		
bbo	BF		
bfo	BF		
bib	BF		
bof	BF		
box	BF		
bwj	BF		
bwq	BF		
bwy	BF		
bxl	BF		
cme	BF		
cpo	BF		
dgd	BF		
dgi	BF		
dgs	BF		
dje	BF		
dnn	BF		
dos	BF		
dya	BF		
dyu	BF		
fra	BF	0	0
ful	BF		
gna	BF		
gux	BF		
kfz	BF		
knz	BF		
kqg	BF		
kst	BF		
kus	BF		
kza	BF		
lee	BF		
lob	BF		
mos	BF	1	1
nnw	BF		
nti	BF		
nuv	BF		
pnl	BF		
pnq	BF		
pug	BF		
rkm	BF		
sbd	BF		
sen	BF		
sep	BF		
seq	BF		
sif	BF		
skq	BF		
sld	BF		
sos	BF		
stj	BF		
sym	BF		
taq	BF	1	1
tiq	BF		
tmh	BF	1	1
tsp	BF		
tuz	BF		
vig	BF		
wbf	BF		
wib	BF		
xrb	BF		
xsm	BF		
bqn	BG		
bul	BG		
chu	BG		
deu	BG		
eng	BG	0	0
fra	BG	0	0
rmn	BG		
rom	BG	0	1
rus	BG		
tur	BG	0	1
txh	BG		
abv	BH	1	1
ara	BH	1	1
mal	BH		
eng	BI	0	0
fra	BI	0	0
run	BI		
swa	BI	0	0
ajg	BJ		
aug	BJ		
ayb	BJ		
bba	BJ		
beh	BJ		
blo	BJ		
bly	BJ		
bqa	BJ		
bqc	BJ		
cbj	BJ		
cib	BJ		
ddn	BJ		
dop	BJ		
fod	BJ		
fon	BJ		
fra	BJ	0	0
fue	BJ		
ful	BJ		
gbh	BJ		
gbs	BJ		
gbx	BJ		
guw	BJ		
ica	BJ		
idd	BJ		
ijj	BJ		
kqk	BJ		
mkl	BJ		
mql	BJ		
mxl	BJ		
nqg	BJ		
nqk	BJ		
ntm	BJ		
pil	BJ		
soy	BJ		
sxw	BJ		
tbz	BJ		
tfi	BJ		
wem	BJ		
wwa	BJ		
xkb	BJ		
xwe	BJ		
xwl	BJ		
yor	BJ		
fra	BL	0	0
eng	BM	0	0
beg	BN	1	1
bsb	BN	1	1
eng	BN	0	0
kxd	BN		
msa	BN		
ttg	BN		
zho	BN	0	0
aro	BO	1	1
aym	BO		
ayr	BO		
brg	BO		
bvl	BO		
caj	BO		
cao	BO		
cap	BO		
cas	BO		
cav	BO		
caw	BO		
cax	BO		
caz	BO		
cyb	BO		
ese	BO		
gnw	BO		
grn	BO		
gui	BO		
gyr	BO		
ign	BO		
ite	BO		
ito	BO		
jor	BO		
lec	BO		
mcd	BO		
mtp	BO		
mzp	BO		
pcp	BO		
pnk	BO		
psm	BO		
puq	BO		
que	BO		
quh	BO		
qul	BO		
rey	BO		
sar	BO	1	1
spa	BO	0	0
srq	BO		
tna	BO		
tno	BO		
trn	BO		
ure	BO		
yuq	BO		
yuz	BO		
nld	BQ		
pap	BQ		
aan	BR	1	1
aap	BR	1	1
acs	BR		
adw	BR		
ait	BR		
ake	BR	1	1
ama	BR		
amc	BR		
aoc	BR		
aox	BR		
api	BR		
apn	BR		
apu	BR		
apv	BR		
apy	BR		
aqz	BR		
arj	BR	1	1
ark	BR	1	1
arr	BR	1	1
aru	BR	1	1
arx	BR	1	1
asn	BR		
asu	BR		
atr	BR		
atx	BR	1	1
aux	BR		
avo	BR		
avv	BR		
awe	BR		
awt	BR		
axg	BR		
bae	BR		
bao	BR		
bkq	BR		
boa	BR		
bor	BR		
bwi	BR		
bzs	BR		
car	BR		
cax	BR		
cbc	BR		
cbs	BR		
ccd	BR		
cin	BR		
cod	BR		
cpb	BR		
cub	BR		
cul	BR		
des	BR		
deu	BR		
dny	BR		
eng	BR	0	0
fun	BR		
gae	BR		
gqn	BR		
grn	BR		
gta	BR		
gub	BR		
gun	BR		
guu	BR		
gvc	BR		
gvj	BR		
gvo	BR		
gvp	BR		
hir	BR		
hix	BR		
hrx	BR		
irn	BR		
ita	BR		
ite	BR		
jaa	BR		
jbt	BR		
jpn	BR		
jua	BR		
jup	BR		
jur	BR		
kav	BR		
kay	BR		
kbb	BR		
kbc	BR		
kgk	BR		
kgp	BR		
kmv	BR		
knm	BR		
knt	BR		
kor	BR		
kpc	BR		
kpj	BR		
kpn	BR		
kqq	BR		
kre	BR		
ktn	BR		
ktx	BR		
kui	BR		
kuq	BR		
kwa	BR		
kxo	BR		
kyr	BR		
kyz	BR		
kzw	BR		
lkd	BR		
lsb	BR		
ltn	BR		
mav	BR		
mbc	BR		
mbj	BR		
mbl	BR		
mcd	BR		
mcf	BR		
mch	BR		
mdz	BR		
mmh	BR		
mmv	BR		
mnd	BR		
mpd	BR		
mpq	BR		
mpu	BR		
mpw	BR		
msp	BR		
myp	BR		
myu	BR		
myy	BR		
mzo	BR		
mzr	BR		
nab	BR		
nds	BR		
nhd	BR		
nuc	BR		
omg	BR		
opy	BR		
orw	BR		
oti	BR		
otu	BR		
oym	BR		
pab	BR		
pad	BR		
paf	BR		
pah	BR		
pak	BR		
pav	BR		
pax	BR		
paz	BR		
pbc	BR		
pdt	BR		
pir	BR		
plu	BR		
pog	BR		
pok	BR		
por	BR	0	0
prr	BR		
pth	BR		
pto	BR		
pur	BR		
pyn	BR		
ram	BR		
rkb	BR		
rmq	BR		
sae	BR		
shb	BR		
sik	BR		
skf	BR		
slj	BR		
spa	BR	0	0
sri	BR		
sru	BR		
suy	BR		
swo	BR		
swx	BR		
tae	BR		
taf	BR		
tba	BR	1	1
tca	BR		
ter	BR		
tgv	BR		
tka	BR		
tkf	BR		
tme	BR		
tpk	BR		
tpn	BR		
tpr	BR		
tpy	BR		
tqb	BR		
tri	BR		
trz	BR		
tud	BR		
tue	BR		
tuo	BR		
tux	BR		
twt	BR		
txi	BR		
txu	BR		
uam	BR		
ukr	BR		
uks	BR		
umo	BR		
unk	BR		
urb	BR		
urp	BR		
uru	BR		
urz	BR		
vec	BR		
vkm	BR		
waf	BR		
wap	BR		
wau	BR		
waw	BR		
way	BR		
wca	BR		
wir	BR		
wmd	BR		
wsu	BR		
wyr	BR		
xai	BR		
xaj	BR		
xak	BR		
xat	BR		
xav	BR		
xbw	BR		
xer	BR		
xet	BR		
xir	BR		
xiy	BR		
xkr	BR		
xmo	BR		
xok	BR		
xoo	BR		
xor	BR		
xpk	BR		
xpn	BR		
xra	BR		
xre	BR		
xri	BR		
xsu	BR		
xtw	BR		
xwa	BR		
xxr	BR		
xyl	BR		
yaa	BR		
yab	BR		
yaw	BR		
ybn	BR		
yrl	BR		
yro	BR		
yui	BR		
ywn	BR		
zkp	BR		
bah	BS		
eng	BS	0	0
bro	BT		
cgk	BT		
dka	BT		
dzl	BT		
dzo	BT		
eng	BT	0	0
goe	BT		
kjz	BT		
lep	BT		
lhp	BT		
lkh	BT		
luk	BT		
lya	BT		
neh	BT		
nep	BT		
npb	BT		
ole	BT		
sgt	BT		
tgf	BT		
tsj	BT		
xkf	BT		
xkz	BT		
nor	BV		
afr	BW	1	0
brl	BW		
eng	BW	0	0
gnk	BW		
gwj	BW		
her	BW		
hio	BW		
hnh	BW		
huc	BW		
kck	BW		
mhw	BW		
nde	BW		
nhr	BW		
nmn	BW		
sbs	BW		
shg	BW		
sna	BW		
tsn	BW		
two	BW		
tyu	BW		
xkv	BW		
yey	BW		
bel	BY	1	1
rus	BY		
bzj	BZ		
cab	BZ		
deu	BZ		
eng	BZ	0	0
kek	BZ		
mop	BZ		
pdt	BZ		
spa	BZ	0	0
yua	BZ		
zho	BZ	0	0
abe	CA		
afr	CA	0	0
aii	CA	0	0
aka	CA	0	0
alq	CA		
amh	CA	0	0
ara	CA	0	0
asb	CA	1	1
ase	CA	1	0
asm	CA		
atj	CA		
aze	CA	0	0
bal	CA		
bcr	CA		
bea	CA		
bel	CA		
ben	CA		
bik	CA	0	0
bin	CA		
bla	CA		
blc	CA		
bod	CA		
bos	CA		
bue	CA		
bul	CA		
byf	CA		
byn	CA	1	1
caf	CA		
cat	CA		
cay	CA		
cdo	CA		
ceb	CA	0	0
ces	CA		
chp	CA		
ciw	CA		
clc	CA		
cld	CA	0	0
cmn	CA		
coo	CA		
cop	CA	0	0
cre	CA		
crg	CA		
crj	CA		
crk	CA		
crl	CA		
crm	CA		
crx	CA		
csw	CA		
cwd	CA		
cym	CA		
dak	CA		
dan	CA		
del	CA		
den	CA		
deu	CA		
dgr	CA		
din	CA		
dtd	CA		
ell	CA		
eng	CA	0	0
est	CA		
ewe	CA		
fas	CA	0	0
fcs	CA		
fij	CA	0	0
fil	CA	0	0
fin	CA		
fra	CA	0	0
fry	CA		
ful	CA		
gaa	CA		
geh	CA		
gej	CA		
git	CA		
gla	CA		
gle	CA		
gsw	CA		
guj	CA		
gwi	CA		
hai	CA		
hak	CA		
har	CA	0	0
has	CA		
hat	CA		
hau	CA	0	0
hax	CA		
hbs	CA		
hdn	CA		
heb	CA	0	0
hei	CA		
hil	CA	0	0
hin	CA		
hmn	CA		
hrv	CA		
hun	CA		
hur	CA		
hye	CA		
ibo	CA		
ike	CA		
iks	CA		
ikt	CA		
iku	CA		
ilo	CA		
ind	CA		
isl	CA		
ita	CA		
jam	CA		
jod	CA		
jpn	CA		
kab	CA	0	0
kan	CA		
kas	CA		
kat	CA		
kaz	CA	0	0
kfr	CA		
khm	CA	0	0
kik	CA		
kin	CA		
kkz	CA		
kne	CA		
kok	CA		
kor	CA		
kri	CA		
krj	CA		
ksw	CA		
kur	CA		
kut	CA		
kwk	CA		
lah	CA		
lao	CA		
lav	CA		
lil	CA		
lin	CA		
lit	CA		
lre	CA		
lub	CA		
lug	CA		
lus	CA		
mal	CA		
mar	CA		
mfe	CA		
mic	CA		
mkd	CA		
mlg	CA		
mlt	CA	0	0
moe	CA		
moh	CA		
mon	CA		
mos	CA		
msa	CA		
mya	CA		
nan	CA		
ncg	CA		
nde	CA		
nds	CA		
nep	CA		
nld	CA		
nor	CA		
nsk	CA		
nsr	CA		
nuk	CA		
nus	CA		
ojb	CA		
ojc	CA		
ojg	CA		
oji	CA		
ojs	CA		
ojw	CA		
oka	CA		
one	CA		
ono	CA		
ori	CA		
orm	CA	0	0
otw	CA		
pag	CA		
pam	CA		
pan	CA		
pdc	CA		
pdt	CA		
pes	CA		
pol	CA		
por	CA		
pqm	CA		
prd	CA		
prs	CA		
ptw	CA		
pus	CA		
rhg	CA		
ron	CA	0	0
rue	CA		
run	CA		
rus	CA		
sag	CA		
scs	CA		
sec	CA		
sek	CA		
shs	CA		
sin	CA		
slk	CA		
slv	CA		
sna	CA		
snd	CA		
snk	CA		
som	CA	0	0
spa	CA	0	0
sqi	CA		
squ	CA		
srp	CA		
srs	CA		
sto	CA		
str	CA		
swa	CA	0	0
swe	CA		
syr	CA	0	0
tam	CA		
tce	CA		
tcy	CA		
tel	CA		
tgl	CA		
tgx	CA		
tha	CA		
thp	CA		
tht	CA		
tir	CA	0	0
tli	CA		
tok	CA	1	0
tsi	CA		
ttm	CA		
tur	CA	0	0
tus	CA		
txc	CA		
uig	CA	0	0
ukr	CA		
umu	CA		
urd	CA		
uzb	CA	0	0
vie	CA	0	0
vls	CA		
war	CA		
wdt	CA		
wmw	CA		
wol	CA		
wuu	CA		
xsl	CA		
yid	CA		
yor	CA		
yue	CA		
zho	CA	0	0
eng	CC	0	0
msa	CC		
agh	CD		
alz	CD		
asv	CD		
bbe	CD		
bbm	CD		
bcp	CD		
bct	CD		
bem	CD		
bhy	CD		
bip	CD		
biz	CD		
bja	CD		
bkf	CD		
bkp	CD		
bkt	CD		
bli	CD		
bmb	CD		
bmg	CD		
bml	CD		
bni	CD		
bnx	CD		
boh	CD		
bpj	CD		
bqu	CD		
brf	CD		
brm	CD		
buf	CD		
buu	CD		
bwl	CD		
bws	CD		
bww	CD		
bxg	CD		
byi	CD		
bzm	CD		
bzo	CD		
cjk	CD		
dez	CD		
diz	CD		
dno	CD		
doo	CD		
dzn	CD		
efe	CD		
flr	CD		
fom	CD		
fra	CD	0	0
fuu	CD		
gey	CD		
gix	CD		
gox	CD		
hav	CD		
hba	CD		
hem	CD		
hke	CD		
hoo	CD		
hum	CD		
jgb	CD		
job	CD		
kbj	CD		
kcv	CD		
kcw	CD		
kdg	CD		
kel	CD		
khx	CD		
khy	CD		
kin	CD		
kkq	CD		
kmw	CD		
kng	CD		
kny	CD		
kon	CD		
kpl	CD		
ksv	CD		
ktf	CD		
ktu	CD		
kty	CD		
kws	CD		
kwy	CD		
kzy	CD		
lal	CD		
lea	CD		
led	CD		
lej	CD		
lel	CD		
les	CD		
lgg	CD		
lgm	CD		
lgz	CD		
lie	CD		
lik	CD		
lin	CD		
liz	CD		
lmi	CD		
lnz	CD		
log	CD		
lol	CD		
loo	CD		
loq	CD		
lse	CD		
lua	CD	1	1
lub	CD		
luj	CD		
lvl	CD		
lwa	CD		
mdi	CD		
mdj	CD		
mdk	CD		
mdm	CD		
mdp	CD		
mdq	CD		
mfc	CD		
mmz	CD		
mnh	CD		
msj	CD		
mwz	CD		
mxh	CD		
myc	CD		
nbd	CD		
nbw	CD		
ndk	CD		
ndl	CD		
ndp	CD		
ndt	CD		
ndw	CD		
nga	CD		
ngb	CD		
ngc	CD		
nix	CD		
niy	CD		
nkw	CD		
nlj	CD		
nlo	CD		
nnb	CD		
noq	CD		
nto	CD		
nue	CD		
nuu	CD		
nxd	CD		
nyc	CD		
nyg	CD		
nyj	CD		
nzd	CD		
okc	CD		
omi	CD		
oml	CD		
pae	CD		
pem	CD		
pmb	CD		
pof	CD		
ppp	CD		
rnd	CD		
shc	CD		
shr	CD		
skt	CD		
slx	CD		
smx	CD		
sng	CD		
soc	CD		
sod	CD		
soe	CD		
soo	CD		
sop	CD		
sub	CD		
swa	CD	0	0
swc	CD	1	1
swf	CD		
szg	CD		
tap	CD		
tbm	CD		
tbt	CD		
tek	CD		
tii	CD		
tll	CD		
tmv	CD		
tor	CD		
vau	CD		
won	CD		
yaf	CD		
yel	CD		
ymg	CD		
yng	CD		
yns	CD		
yom	CD		
zla	CD		
zmb	CD		
zmf	CD		
zmp	CD		
zmq	CD		
zms	CD		
zmw	CD		
zmz	CD		
zne	CD		
aiy	CF		
aja	CF		
axk	CF		
bbp	CF		
bdt	CF		
bff	CF		
bfl	CF		
bjo	CF		
bkg	CF		
bkj	CF		
bme	CF		
boy	CF		
bpd	CF		
bqk	CF		
bvq	CF		
deq	CF		
dgk	CF		
fra	CF	0	0
fui	CF		
ful	CF		
fuu	CF		
gba	CF		
gbg	CF		
gbp	CF		
gbq	CF		
gbv	CF		
gdi	CF		
geq	CF		
gnz	CF		
gso	CF		
gya	CF		
gyg	CF		
kah	CF		
kbn	CF		
kcm	CF		
kkj	CF		
ksp	CF		
kuw	CF		
kwv	CF		
kym	CF		
lin	CF		
liy	CF		
lna	CF		
lnl	CF		
mcx	CF		
mdd	CF		
mdn	CF		
mgn	CF		
myb	CF		
mzv	CF		
nbm	CF		
ndy	CF		
ngd	CF		
ngg	CF		
nmc	CF		
nmj	CF		
nzk	CF		
pnz	CF		
rou	CF		
sag	CF		
sbz	CF		
snj	CF		
sqm	CF		
tor	CF		
ukh	CF		
vae	CF		
yaj	CF		
yky	CF		
yul	CF		
zne	CF		
akw	CG		
beq	CG		
bkw	CG		
bmw	CG		
bok	CG		
bui	CG		
bvx	CG		
bwz	CG		
dde	CG		
ebo	CG		
fra	CG	0	0
ifm	CG		
iyx	CG		
kkw	CG		
koh	CG		
kon	CG		
kwc	CG		
kxx	CG		
ldi	CG		
lin	CG		
lli	CG		
mbm	CG		
mdt	CG		
mdu	CG		
mdw	CG		
mkw	CG		
moj	CG		
mow	CG		
nda	CG		
ndn	CG		
ngz	CG		
njx	CG		
nzu	CG		
sdj	CG		
tsa	CG		
tyi	CG		
tyx	CG		
vif	CG		
xku	CG		
zmx	CG		
ara	CH	0	0
deu	CH		
eng	CH	0	0
fra	CH	0	1
gsw	CH		
hbs	CH		
ita	CH		
lmo	CH		
por	CH		
rmo	CH		
roh	CH		
rom	CH	0	1
sgg	CH		
slf	CH		
spa	CH	0	0
sqi	CH		
ssr	CH		
tur	CH	0	0
wae	CH		
aba	CI		
abi	CI		
abr	CI		
abu	CI		
adj	CI		
ahi	CI		
ahm	CI		
ahp	CI		
ald	CI		
any	CI		
ati	CI		
avi	CI		
bam	CI		
bci	CI		
bet	CI		
bev	CI		
bjw	CI		
bqv	CI		
btg	CI		
das	CI		
dic	CI		
dnj	CI		
dyi	CI		
dyu	CI		
ebr	CI		
ega	CI		
eot	CI		
esm	CI		
fra	CI	0	0
ggu	CI		
gie	CI		
gnj	CI		
goa	CI		
god	CI		
gov	CI		
gud	CI		
gwa	CI		
gxx	CI		
hau	CI	0	1
hwa	CI		
jek	CI		
jod	CI		
jud	CI		
kfo	CI		
kga	CI		
kqm	CI		
ktj	CI		
kwp	CI		
kxb	CI		
kyf	CI		
kzc	CI		
lda	CI		
lob	CI		
loi	CI		
lor	CI		
mka	CI		
moa	CI		
mtb	CI		
mxx	CI		
neb	CI		
ney	CI		
nfr	CI		
nhb	CI		
nku	CI		
nwb	CI		
nzi	CI		
plr	CI		
pye	CI		
seb	CI		
sef	CI		
sev	CI		
ted	CI		
tgw	CI		
tjn	CI		
wan	CI		
wec	CI		
wob	CI		
xgb	CI		
yre	CI		
eng	CK	0	0
fij	CK	0	0
fil	CK	0	0
fra	CK	0	0
pkp	CK		
pnh	CK		
rar	CK		
rkh	CK		
alc	CL		
arn	CL	1	1
csg	CL		
eng	CL	0	0
huh	CL	1	1
kuz	CL		
rap	CL		
spa	CL	0	0
yag	CL		
aal	CM	1	1
abb	CM		
add	CM		
ael	CM		
agq	CM		
ags	CM		
aku	CM		
anv	CM		
ara	CM	0	0
asj	CM		
ass	CM		
ato	CM		
azo	CM		
baf	CM		
bag	CM		
bas	CM		
bav	CM		
baw	CM		
bax	CM		
bbi	CM		
bbj	CM		
bbk	CM		
bbq	CM		
bbw	CM		
bbx	CM		
bby	CM		
bce	CM		
bcw	CM	1	1
bdn	CM	1	1
bdu	CM		
beb	CM		
bec	CM		
bfd	CM		
bfj	CM		
bfm	CM		
bfp	CM		
bgf	CM		
bgj	CM		
bhs	CM	1	1
biw	CM		
bju	CM		
bkc	CM		
bkh	CM		
bkm	CM		
bko	CM		
bmo	CM		
bmv	CM		
bnz	CM		
boe	CM		
bpc	CM		
bqd	CM		
bqm	CM		
bqo	CM		
bqt	CM		
bqz	CM		
bri	CM		
bse	CM		
bsi	CM		
bss	CM		
btc	CM		
bum	CM		
bvg	CM		
bvm	CM		
bwh	CM		
bwt	CM		
bxp	CM		
bxs	CM		
byb	CM		
byv	CM		
bzv	CM		
ckx	CM		
cnq	CM		
cuv	CM	1	1
dae	CM		
dbq	CM	1	1
dek	CM		
dii	CM		
dkx	CM	1	1
dme	CM	1	1
dmm	CM		
dmo	CM		
dow	CM		
dua	CM		
dur	CM		
duz	CM		
ekm	CM		
emn	CM		
emz	CM		
eng	CM	0	0
eto	CM		
etu	CM		
ewo	CM		
fak	CM		
fal	CM		
fan	CM		
fll	CM		
fmp	CM		
fra	CM	0	0
fub	CM		
ful	CM		
fuv	CM		
gba	CM		
gde	CM	1	1
gid	CM	1	1
gis	CM	1	1
giz	CM	1	1
gke	CM		
gmm	CM		
gmn	CM		
gnd	CM	1	1
gou	CM	1	1
gya	CM		
gyi	CM		
hau	CM	0	1
hij	CM		
hna	CM	1	1
hya	CM	1	1
isu	CM		
iyo	CM		
jbu	CM		
jgo	CM		
jia	CM	1	1
jim	CM	1	1
kau	CM		
kdz	CM		
ken	CM		
kfl	CM		
kfn	CM		
kid	CM		
kkj	CM		
klc	CM		
kme	CM		
kmp	CM		
knc	CM		
knp	CM		
kot	CM	1	1
kqx	CM	1	1
ksf	CM		
kvj	CM	1	1
kvm	CM		
kwu	CM		
kzr	CM		
lbi	CM		
lem	CM		
leo	CM		
lfa	CM		
lmp	CM		
lmx	CM		
lns	CM		
luw	CM		
maf	CM	1	1
mbo	CM		
mcn	CM	1	1
mcp	CM		
mcs	CM		
mct	CM		
mcu	CM		
mdd	CM		
mea	CM		
meq	CM	1	1
mfd	CM		
mff	CM		
mfh	CM	1	1
mfi	CM	1	1
mfj	CM	1	1
mfk	CM	1	1
mgg	CM		
mgo	CM		
mhk	CM		
mif	CM	1	1
mij	CM		
mkk	CM		
mlb	CM		
mlr	CM	1	1
mlw	CM	1	1
mmu	CM		
mnf	CM		
mpi	CM	1	1
mqb	CM	1	1
mru	CM		
mse	CM	1	1
msv	CM	1	1
mtk	CM		
mua	CM		
muc	CM		
mug	CM	1	1
muo	CM		
muy	CM	1	1
mxf	CM	1	1
mxu	CM	1	1
myg	CM		
mzd	CM		
nbv	CM		
ncr	CM		
ndb	CM		
ndu	CM		
nfu	CM		
nge	CM		
ngj	CM		
ngn	CM		
ngv	CM		
ngy	CM		
nhu	CM		
njj	CM		
njy	CM		
nkc	CM		
nla	CM		
nmg	CM		
nml	CM		
nmr	CM		
nnh	CM		
nnx	CM		
nnz	CM		
nsh	CM		
nvo	CM		
nwe	CM		
nza	CM		
obl	CM		
oku	CM		
ost	CM		
ozm	CM		
pbi	CM	1	1
pfe	CM		
pmm	CM		
pmn	CM		
pny	CM		
sba	CM		
sgi	CM		
shu	CM	1	1
sox	CM		
sqm	CM		
swq	CM	1	1
szv	CM		
tik	CM		
toz	CM		
tsh	CM	1	1
ttf	CM		
tui	CM		
tvu	CM		
twn	CM		
udl	CM	1	1
uiv	CM		
usk	CM		
vut	CM		
weh	CM		
wes	CM		
wok	CM		
www	CM		
xed	CM	1	1
xmb	CM		
xmd	CM	1	1
xmg	CM		
xmj	CM	1	1
xuo	CM		
yam	CM		
yas	CM		
yat	CM		
yav	CM		
ybb	CM		
yei	CM		
yko	CM		
zhw	CM		
zuy	CM	1	1
acn	CN		
adi	CN		
adx	CN		
aeu	CN		
ahk	CN		
aib	CN	1	1
aih	CN		
aou	CN		
atb	CN		
aub	CN		
aza	CN		
bbh	CN	1	1
bca	CN		
bfc	CN		
bfs	CN		
bgk	CN	1	1
bje	CN		
blr	CN	1	1
blt	CN		
bmt	CN		
bod	CN		
bpn	CN		
bqh	CN		
bua	CN		
buh	CN		
bvp	CN		
bwn	CN		
bwx	CN		
bxd	CN		
bxu	CN		
byk	CN		
byo	CN		
bzi	CN		
cda	CN		
cdo	CN		
cdy	CN		
cjy	CN		
clk	CN		
cmn	CN	1	1
cng	CN		
cnp	CN		
cov	CN		
cpx	CN		
cqd	CN		
csl	CN		
csp	CN		
cuq	CN		
cuu	CN		
czh	CN		
czo	CN		
doc	CN		
dta	CN		
duu	CN		
eee	CN		
emq	CN		
eng	CN	0	0
enu	CN		
ero	CN		
ers	CN		
evn	CN	1	1
gan	CN	1	1
giq	CN		
gir	CN		
giu	CN		
giw	CN		
gld	CN	1	1
gqi	CN		
gqu	CN		
gro	CN		
hak	CN	1	1
hea	CN		
hks	CN		
hle	CN		
hma	CN		
hmc	CN		
hmd	CN		
hme	CN		
hmg	CN		
hmh	CN		
hmi	CN		
hmj	CN		
hml	CN		
hmm	CN		
hmn	CN		
hmp	CN		
hmq	CN		
hms	CN		
hmw	CN		
hmy	CN		
hmz	CN		
hni	CN		
hnj	CN		
how	CN		
hrm	CN		
hsn	CN	1	1
huj	CN		
huo	CN	1	1
huq	CN		
iii	CN		
ili	CN	1	1
ium	CN		
jih	CN		
jio	CN		
jiq	CN		
jiu	CN		
jiy	CN		
juc	CN	1	1
jya	CN		
kac	CN		
kaf	CN		
kaz	CN	0	1
kfj	CN		
kgy	CN		
khb	CN		
khf	CN	1	1
khg	CN		
kir	CN	1	1
kjg	CN	1	1
kjh	CN	1	1
kkn	CN		
kmc	CN		
kor	CN		
ktp	CN		
kxs	CN		
kyp	CN		
laq	CN		
lay	CN		
lbc	CN		
lbf	CN		
lbj	CN		
lbt	CN		
lcp	CN	0	0
lhi	CN		
lhm	CN		
lhu	CN		
lic	CN		
lis	CN		
lkc	CN		
llh	CN		
lov	CN		
lpo	CN		
lsi	CN		
lsn	CN		
ltc	CN		
lwm	CN		
lwu	CN		
lzh	CN		
mhu	CN		
mhx	CN		
mjg	CN		
mji	CN		
mkg	CN		
mlm	CN		
mmd	CN		
mml	CN	1	1
mmr	CN		
mnc	CN	1	1
mnp	CN		
mon	CN		
muq	CN		
mvf	CN		
mww	CN		
mxj	CN		
mzs	CN		
nan	CN	1	1
nmy	CN		
nos	CN		
nru	CN		
nsd	CN		
nsf	CN		
nsv	CN		
nuf	CN		
nun	CN		
nxq	CN		
och	CN		
onb	CN		
orh	CN	1	1
otb	CN		
oui	CN	1	1
pal	CN		
pcc	CN		
pce	CN	1	1
pdi	CN		
peh	CN		
pha	CN		
phh	CN		
phq	CN		
pll	CN	1	1
ply	CN	1	1
pmi	CN		
pmj	CN		
pnu	CN		
prk	CN	1	1
qvy	CN		
qxs	CN		
rbb	CN	1	1
ril	CN	1	1
rus	CN		
sce	CN		
sfm	CN		
sgk	CN		
shn	CN		
shx	CN		
sjo	CN	1	1
slr	CN	1	1
smh	CN		
srh	CN		
stu	CN	1	1
swi	CN		
sxg	CN		
tat	CN	0	1
tct	CN		
tdd	CN		
thf	CN		
tiz	CN		
tji	CN		
tjs	CN		
tsj	CN		
tsk	CN		
twh	CN		
twm	CN		
txb	CN		
txg	CN		
tyv	CN	0	1
uig	CN	1	1
uuu	CN	1	1
uzb	CN	0	1
uzn	CN	0	1
vie	CN	0	1
vwa	CN	1	1
wbl	CN		
wbm	CN	1	1
wmg	CN		
wuh	CN		
wuu	CN	1	1
wxa	CN		
xal	CN		
xct	CN		
xmn	CN		
xnh	CN		
xpy	CN		
xsr	CN		
xto	CN		
xzh	CN		
ybe	CN	1	1
ybk	CN		
ych	CN		
ycl	CN		
ygp	CN		
yha	CN		
yhl	CN		
yif	CN		
yig	CN		
yik	CN		
yip	CN		
yiq	CN		
yit	CN		
yiu	CN		
yiv	CN		
yix	CN		
yiz	CN		
ykl	CN		
ykn	CN		
ykt	CN		
yku	CN		
ylm	CN		
yln	CN		
ylo	CN		
ymc	CN		
ymd	CN		
ymh	CN		
ymi	CN		
ymq	CN		
ymx	CN		
ymz	CN		
yna	CN		
yne	CN		
ypa	CN		
ypb	CN		
ypg	CN		
yph	CN		
ypm	CN		
ypn	CN		
ypo	CN		
ypp	CN		
ypz	CN		
yrn	CN		
ysd	CN		
ysg	CN		
ysn	CN		
yso	CN		
ysp	CN		
ysy	CN		
yta	CN		
ytl	CN		
ytp	CN		
yue	CN	1	1
yuy	CN		
ywl	CN		
ywq	CN		
ywt	CN		
ywu	CN		
yyz	CN		
yzg	CN		
yzk	CN		
zal	CN		
zbl	CN	1	0
zch	CN		
zeh	CN		
zgb	CN		
zgm	CN		
zgn	CN		
zha	CN		
zhb	CN		
zhd	CN		
zhn	CN		
zho	CN	1	1
zkt	CN		
zlj	CN		
zln	CN		
zlq	CN		
zng	CN	1	1
zqe	CN		
zyb	CN		
zyg	CN		
zyj	CN		
zyn	CN		
zzj	CN		
aca	CO		
ana	CO	1	1
ano	CO	1	1
ans	CO		
arh	CO	1	1
bao	CO		
bdc	CO		
bmr	CO		
boa	CO		
bsn	CO		
cbb	CO		
cbc	CO		
cbd	CO		
cbg	CO		
cbv	CO		
cby	CO		
chb	CO		
cmi	CO		
coe	CO		
crf	CO		
csn	CO		
cto	CO		
cub	CO		
cui	CO		
fra	CO	0	0
gob	CO		
guc	CO		
guh	CO		
gum	CO		
guo	CO		
hto	CO		
icr	CO		
inb	CO		
inj	CO		
kbh	CO		
kog	CO		
kpc	CO		
kvn	CO		
kwi	CO		
mbn	CO		
mbp	CO		
mbr	CO		
mcl	CO		
mot	CO		
myy	CO		
noa	CO		
noj	CO		
pbb	CO		
pij	CO		
pio	CO		
pln	CO		
prz	CO		
pui	CO		
sja	CO		
slc	CO		
snn	CO		
spa	CO	0	0
sri	CO		
tav	CO		
tbn	CO		
tdc	CO		
ten	CO		
tit	CO		
tnb	CO		
tnc	CO		
tnd	CO		
ttk	CO		
tue	CO		
tuf	CO		
tuo	CO		
ycn	CO		
ynu	CO		
yrl	CO		
yui	CO		
yup	CO		
eng	CQ	0	1
brn	CR		
bzd	CR		
cjp	CR		
csr	CR		
fra	CR	0	0
gut	CR		
gym	CR		
jam	CR		
pdt	CR		
rib	CR		
rnb	CR		
spa	CR	0	0
tfr	CR		
ydd	CR		
yid	CR		
csf	CU		
fra	CU	0	0
luq	CU		
spa	CU	0	0
fra	CV	0	0
kea	CV		
por	CV		
nld	CW		
pap	CW		
spa	CW	0	0
eng	CX	0	0
acy	CY	1	1
ara	CY	0	1
bul	CY		
ecy	CY		
ell	CY		
eng	CY	0	0
fil	CY	0	0
fra	CY	0	1
hin	CY		
hye	CY		
ron	CY	0	0
rus	CY		
sin	CY		
tur	CY	0	1
ces	CZ	1	1
cse	CZ		
czk	CZ		
deu	CZ		
eng	CZ	0	0
fra	CZ	0	0
pol	CZ		
rom	CZ	0	1
rus	CZ		
slk	CZ		
ukr	CZ		
ara	DE	0	0
bar	DE	1	1
bos	DE	0	0
bul	DE	0	0
dan	DE	0	1
deu	DE	1	1
dsb	DE		
ell	DE		
eng	DE	0	0
fas	DE	0	0
fra	DE	0	1
frk	DE		
frr	DE		
frs	DE		
gmh	DE		
gml	DE		
goh	DE		
gsg	DE	1	1
gsw	DE		
hbs	DE		
hrv	DE		
hsb	DE		
hun	DE	0	0
ita	DE		
ksh	DE		
kur	DE		
mkd	DE		
nds	DE	1	1
nld	DE		
osx	DE		
pfl	DE		
pol	DE		
pox	DE		
rus	DE		
spa	DE	0	0
sqi	DE		
srp	DE		
stq	DE		
swg	DE		
sxu	DE		
tur	DE	0	0
ukr	DE		
vmf	DE		
wep	DE		
yec	DE		
eng	DG	0	0
aar	DJ	1	1
ara	DJ	0	1
fra	DJ	0	0
som	DJ	1	1
dan	DK	1	1
deu	DK	0	1
dsl	DK	1	1
eng	DK	0	0
fao	DK	0	1
fra	DK	0	0
jut	DK	1	1
kal	DK	1	1
rmd	DK	1	1
rom	DK	0	1
swe	DK	0	1
eng	DM	0	0
fra	DM	0	0
doq	DO	1	0
eng	DO	0	0
fra	DO	0	0
hat	DO	0	0
spa	DO	0	0
aao	DZ	1	1
ajs	DZ	1	1
ara	DZ	0	1
arb	DZ	0	1
arq	DZ	1	1
asp	DZ		
blv	DZ		
cnu	DZ	1	1
eng	DZ	0	0
fra	DZ	0	0
grr	DZ	1	1
kab	DZ	1	1
kcy	DZ		
mey	DZ	1	1
mzb	DZ	1	1
nxm	DZ		
oua	DZ	1	1
rif	DZ	1	1
shi	DZ	1	1
shy	DZ	1	1
thv	DZ	1	1
tia	DZ	1	1
tjo	DZ	1	1
tmh	DZ	1	1
ara	EA	0	1
eng	EA	0	0
fra	EA	0	0
rif	EA	1	1
spa	EA	0	0
acu	EC		
anb	EC		
auc	EC		
cbi	EC		
cof	EC		
con	EC		
ecs	EC		
jiv	EC		
kwi	EC		
mue	EC		
qud	EC		
que	EC		
qug	EC		
quw	EC		
qvi	EC		
qvj	EC		
qvz	EC		
qxl	EC		
qxr	EC		
sey	EC		
sja	EC		
spa	EC	0	0
teb	EC		
zro	EC		
ekk	EE		
eng	EE	0	0
eso	EE		
est	EE		
fin	EE		
fra	EE	0	0
ile	EE	1	1
rus	EE		
ukr	EE		
vro	EE		
aec	EG	1	1
afb	EG	1	1
ara	EG	0	1
arb	EG	0	1
arq	EG	0	1
ary	EG	0	1
arz	EG	1	1
avl	EG	1	1
ayl	EG	1	1
bej	EG	0	1
cop	EG	1	1
egy	EG	1	1
ell	EG		
eng	EG	0	0
esl	EG		
fia	EG		
fra	EG	0	0
hbo	EG	1	1
hyw	EG		
onw	EG		
siz	EG	1	1
xnz	EG		
ara	EH	0	1
arb	EH	0	1
ary	EH	1	1
mey	EH	1	1
aar	ER	1	1
ara	ER	0	1
bej	ER	0	1
byn	ER	1	1
dlk	ER	1	1
eng	ER	0	0
kun	ER		
nrb	ER		
ssy	ER	1	1
tig	ER	1	1
tir	ER	1	0
ara	ES	0	1
arg	ES	1	1
ast	ES		
bul	ES		
cat	ES	1	1
csc	ES		
deu	ES		
eng	ES	0	0
eus	ES		
ext	ES	1	1
fax	ES	1	1
fra	ES	0	1
glg	ES		
gnc	ES	1	1
grn	ES		
ita	ES		
mxi	ES		
nld	ES		
oci	ES		
osp	ES		
pol	ES		
por	ES		
quq	ES		
rif	ES	0	1
rmq	ES		
ron	ES	0	0
rus	ES		
spa	ES	0	0
ssp	ES		
sxo	ES		
txr	ES		
ukr	ES		
urd	ES		
vsv	ES		
wol	ES		
xaa	ES	1	1
xaq	ES	1	1
xce	ES		
xib	ES		
xls	ES		
xvn	ES		
zho	ES	0	0
aar	ET	1	1
agj	ET	1	1
ahg	ET	1	1
aiw	ET		
alw	ET	1	1
amf	ET		
amh	ET	1	1
anu	ET		
arv	ET	1	1
awn	ET	1	1
bcq	ET		
bji	ET	1	1
bst	ET		
bsw	ET	1	1
bwo	ET		
bxe	ET	1	1
cra	ET		
dim	ET		
dox	ET	1	1
doz	ET		
drs	ET	1	1
dsh	ET	1	1
dtn	ET		
dwr	ET		
eng	ET	0	0
eth	ET		
gax	ET	1	1
gaz	ET	1	1
gdl	ET	1	1
gez	ET	1	1
gft	ET	1	1
gii	ET	1	1
gmv	ET		
gof	ET		
gru	ET	1	1
guk	ET		
gwd	ET	1	1
gyl	ET		
gza	ET		
hae	ET	1	1
har	ET	1	1
hdy	ET	1	1
hoz	ET		
ior	ET	1	1
jnj	ET		
kbr	ET		
kcx	ET		
kmq	ET		
kmw	ET		
kqy	ET		
ktb	ET	1	1
kun	ET		
kxc	ET	1	1
kxh	ET		
lgn	ET		
liq	ET	1	1
mdx	ET		
mdy	ET		
mfx	ET		
moy	ET		
mpe	ET		
muz	ET		
mvz	ET	1	1
myf	ET		
mym	ET		
myo	ET		
mys	ET	1	1
nnj	ET		
noz	ET		
nus	ET		
orm	ET	1	1
oyd	ET		
rer	ET		
sbf	ET		
sgw	ET	1	1
she	ET		
sid	ET	1	1
som	ET	1	1
stv	ET	1	1
suq	ET		
sze	ET		
tir	ET	1	0
tsb	ET	1	1
wal	ET		
wle	ET	1	1
woy	ET		
wti	ET		
xan	ET	1	1
xwg	ET		
zay	ET		
zwa	ET	1	1
ara	FI	0	0
deu	FI		
eng	FI	0	0
est	FI		
fin	FI		
fra	FI	0	0
fse	FI		
fss	FI		
rmf	FI		
rom	FI	0	0
rus	FI		
sjk	FI		
sme	FI		
smn	FI		
sms	FI		
som	FI	0	0
swe	FI		
bwb	FJ	1	1
eng	FJ	0	0
fij	FJ	1	1
goo	FJ	1	1
hif	FJ	1	0
hin	FJ	0	0
llx	FJ	1	1
lmv	FJ	1	1
rtm	FJ	1	1
wyy	FJ	1	1
eng	FK	0	0
spa	FK	0	0
chk	FM	1	1
eng	FM	0	0
kos	FM		
kpg	FM		
mkj	FM		
mrl	FM		
ngm	FM		
nkr	FM		
nmt	FM		
nuw	FM		
pfa	FM		
pif	FM		
pon	FM		
puw	FM		
stw	FM		
uli	FM		
woe	FM		
yap	FM		
fao	FO	1	1
bre	FR		
cat	FR		
cos	FR		
deu	FR		
emx	FR		
eng	FR	0	1
eus	FR		
fra	FR	1	1
frm	FR		
fro	FR		
frp	FR		
fsl	FR		
gsw	FR		
hmn	FR		
hnj	FR		
ido	FR	1	1
ina	FR	0	1
ita	FR		
nld	FR		
obt	FR		
oci	FR		
pcd	FR		
por	FR		
pro	FR		
rom	FR	0	1
sdt	FR		
spa	FR	0	0
xaq	FR	1	1
xbm	FR		
xtg	FR		
zrp	FR		
bbg	GA		
buw	GA		
dma	GA		
fra	GA	0	0
gev	GA		
kbs	GA		
keb	GA		
koq	GA		
kzo	GA		
lup	GA		
mhb	GA		
mye	GA		
nmd	GA		
nra	GA		
nxo	GA		
nzb	GA		
pic	GA		
puu	GA		
sak	GA		
sbw	GA		
snq	GA		
swj	GA		
sxe	GA		
syi	GA		
syx	GA		
tck	GA		
teg	GA		
tsv	GA		
vum	GA		
wdd	GA		
wum	GA		
zmn	GA		
ang	GB		
ara	GB	0	0
ben	GB		
bfi	GB		
cnx	GB		
cor	GB		
cym	GB		
deu	GB		
eng	GB	1	1
enm	GB	1	1
fra	GB	0	1
ghc	GB		
gla	GB		
gle	GB		
guj	GB		
ita	GB		
lah	GB		
lit	GB		
nrf	GB		
nrn	GB		
oco	GB		
okl	GB		
owl	GB		
pan	GB		
pld	GB		
pol	GB		
por	GB		
qya	GB	1	0
rme	GB		
rmw	GB		
rom	GB	0	0
ron	GB	0	0
sco	GB		
sjn	GB	1	1
som	GB	0	0
spa	GB	0	0
tam	GB		
trl	GB		
tur	GB	0	0
urd	GB		
wlm	GB		
xcb	GB		
xno	GB		
xpi	GB		
zho	GB	0	0
eng	GD	0	0
gcl	GD		
abk	GE	1	1
aze	GE	1	1
bbl	GE		
bhn	GE	1	1
fra	GE	0	0
hye	GE		
kat	GE		
kmr	GE		
kur	GE		
lzz	GE		
oav	GE		
oge	GE		
oss	GE		
rus	GE		
sva	GE		
uum	GE	0	1
xmf	GE		
eme	GF		
fra	GF	0	0
gcr	GF		
hmn	GF		
hnj	GF		
zho	GF	0	0
eng	GG	0	1
abr	GH		
acd	GH		
ada	GH		
ade	GH		
adq	GH		
ads	GH		
afh	GH	1	1
afu	GH		
aha	GH		
aka	GH	1	1
akp	GH		
anf	GH		
any	GH		
avn	GH		
bib	GH		
bim	GH		
biv	GH		
bov	GH		
bud	GH		
bwu	GH		
cko	GH		
cli	GH		
cll	GH		
cpn	GH		
dag	GH		
dga	GH		
doy	GH		
eng	GH	0	0
ewe	GH		
fat	GH		
fra	GH	0	0
ful	GH		
gaa	GH		
gjn	GH		
gpe	GH		
gse	GH		
gur	GH		
gwx	GH		
hag	GH		
hau	GH	0	1
jmr	GH		
jwi	GH		
kdh	GH		
kma	GH		
kph	GH		
kus	GH		
kye	GH		
kzc	GH		
lar	GH		
lef	GH		
lgq	GH		
lig	GH		
lip	GH		
maw	GH		
mos	GH		
mzw	GH		
naw	GH		
ncu	GH		
nfr	GH		
nko	GH		
nkq	GH		
nlu	GH		
nnu	GH		
ntr	GH		
nyb	GH		
nzi	GH		
pil	GH		
saf	GH		
sfw	GH		
sig	GH		
sil	GH		
snw	GH		
ssl	GH		
tcd	GH		
tpm	GH		
twi	GH		
vag	GH		
wlx	GH		
wss	GH		
xkt	GH		
xon	GH		
xsm	GH		
xxb	GH		
eng	GI	0	0
spa	GI	0	1
dan	GL		
kal	GL		
emk	GM		
eng	GM	0	0
fra	GM	0	0
ful	GM		
man	GM		
wof	GM		
bcg	GN		
bgo	GN		
bmd	GN		
bqf	GN		
bsp	GN		
bsv	GN		
emk	GN		
fra	GN	0	0
fuf	GN		
ful	GN		
gkp	GN		
gus	GN		
jad	GN		
kke	GN		
knu	GN		
kpe	GN		
kqs	GN		
ldm	GN		
llc	GN		
lma	GN		
man	GN		
mbv	GN		
mfg	GN		
mku	GN		
mnk	GN		
msc	GN		
naj	GN		
nqo	GN	1	1
pbp	GN		
sus	GN		
tod	GN		
yal	GN		
zil	GN		
fra	GP	0	0
gcf	GP		
bng	GQ		
bnm	GQ		
bvb	GQ		
bxc	GQ		
fab	GQ		
fan	GQ		
fpe	GQ	1	0
fra	GQ	0	0
nui	GQ		
por	GQ		
spa	GQ	0	0
aat	GR		
bul	GR		
cpg	GR		
deu	GR		
ecr	GR		
ell	GR	1	1
eng	GR	0	0
fra	GR	0	0
gmy	GR		
grc	GR		
gss	GR		
lab	GR		
mkd	GR		
omn	GR		
pnt	GR		
rge	GR		
rom	GR	0	1
ruq	GR		
sqi	GR		
tsd	GR		
tur	GR	0	1
xle	GR		
xmk	GR		
yej	GR		
eng	GS	0	0
acr	GT		
agu	GT		
caa	GT		
cab	GT		
cac	GT		
cak	GT		
ckz	GT		
cob	GT		
emy	GT		
eng	GT	0	0
gsm	GT		
itz	GT		
ixl	GT		
jac	GT		
kek	GT		
kjb	GT		
knj	GT		
mam	GT		
mop	GT		
poc	GT		
poh	GT		
quc	GT		
qum	GT		
quv	GT		
spa	GT	0	0
ttc	GT		
tzj	GT		
usp	GT		
xin	GT		
cha	GU	1	1
eng	GU	0	0
fil	GU	0	0
bab	GW		
bif	GW		
bjg	GW		
ble	GW		
ccj	GW		
eja	GW		
eng	GW	0	0
fra	GW	0	0
ful	GW		
kcj	GW		
knf	GW		
lgs	GW		
msw	GW		
pbo	GW		
por	GW		
pov	GW		
ake	GY	1	1
aox	GY		
arw	GY	1	1
brc	GY		
eng	GY	0	0
gyn	GY		
mzx	GY		
pbc	GY		
skw	GY		
tdm	GY		
wap	GY		
cmn	HK		
eng	HK	0	0
yue	HK		
zho	HK	1	1
cab	HN		
eng	HN	0	0
hds	HN		
jic	HN		
len	HN		
miq	HN		
pay	HN		
spa	HN	0	0
bos	HR		
ckm	HR		
csq	HR		
dlm	HR		
eng	HR	0	0
fra	HR	0	0
hbs	HR		
hrv	HR		
ist	HR		
ita	HR		
kjv	HR		
rom	HR	0	1
rsk	HR		
ruo	HR		
sqi	HR		
srp	HR		
vec	HR		
xli	HR		
ysl	HR		
ase	HT	0	0
fra	HT	0	0
hat	HT	1	0
hvc	HT		
deu	HU		
eng	HU	0	0
fra	HU	0	0
hbs	HU		
hrv	HU		
hsh	HU		
hun	HU	1	1
lng	HU		
ohu	HU		
rom	HU	0	1
ron	HU	0	1
slk	HU		
slv	HU		
srp	HU		
xhc	HU	1	1
ysc	HU		
deu	IC		
eng	IC	0	0
fra	IC	0	0
ita	IC	0	0
spa	IC	0	1
aax	ID		
aaz	ID	1	1
abl	ID	1	1
abs	ID	1	1
abz	ID		
ace	ID	1	1
adn	ID		
adr	ID	1	1
afz	ID		
agf	ID	1	1
ahh	ID		
aip	ID		
air	ID		
akb	ID	1	1
akc	ID	1	1
akg	ID	1	1
alo	ID	1	1
alp	ID	1	1
amk	ID	1	1
amq	ID	1	1
amv	ID	1	1
and	ID	1	1
aol	ID	1	1
aos	ID		
aoz	ID	1	1
apg	ID	1	1
apx	ID	1	1
aqm	ID		
asc	ID	1	1
asi	ID		
asl	ID	1	1
asy	ID		
asz	ID	1	1
atq	ID	1	1
auq	ID	1	1
auu	ID		
auw	ID		
awh	ID		
awr	ID		
aws	ID		
awu	ID		
awv	ID		
awy	ID		
ayz	ID		
bac	ID	1	1
baj	ID	1	1
ban	ID	1	1
bay	ID	1	1
bbc	ID	1	1
bcd	ID	1	1
bdb	ID	1	1
bdl	ID	1	1
bdw	ID		
bdx	ID	1	1
bed	ID	1	1
bei	ID	1	1
bep	ID	1	1
beu	ID		
bew	ID	1	1
bfe	ID		
bfg	ID	1	1
bfn	ID		
bgb	ID	1	1
bgv	ID	1	1
bgy	ID	1	1
bgz	ID	1	1
bhc	ID	1	1
bhp	ID	1	1
bhq	ID	1	1
bhv	ID	1	1
bhw	ID	1	1
bhz	ID	1	1
bjn	ID	1	1
bkl	ID		
bkn	ID	1	1
bkr	ID	1	1
bkz	ID	1	1
bld	ID	1	1
blf	ID	1	1
blj	ID	1	1
bls	ID	1	1
blz	ID	1	1
bna	ID	1	1
bnd	ID	1	1
bne	ID	1	1
bnf	ID	1	1
bnq	ID	1	1
bnu	ID	1	1
bnv	ID		
bpg	ID	1	1
bpo	ID		
bpp	ID		
bpq	ID	1	1
bpv	ID	1	1
bpz	ID	1	1
bqb	ID		
bqq	ID		
bqr	ID	1	1
bqy	ID		
brp	ID		
brs	ID	1	1
bsa	ID	1	1
bsm	ID	1	1
bsu	ID	1	1
btd	ID	1	1
bth	ID	1	1
bti	ID		
btj	ID	1	1
btm	ID	1	1
bts	ID	1	1
btx	ID	1	1
bty	ID	1	1
btz	ID	1	1
bug	ID	1	1
bup	ID	1	1
bve	ID	1	1
bvk	ID	1	1
bvt	ID	1	1
bvu	ID	1	1
bvz	ID		
bwp	ID		
byd	ID	1	1
byl	ID		
bzb	ID	1	1
bzl	ID	1	1
bzn	ID	1	1
bzp	ID		
bzq	ID	1	1
bzu	ID		
cdo	ID		
cia	ID	1	1
cml	ID	1	1
cmn	ID	0	1
cns	ID		
daz	ID		
dbe	ID		
dbf	ID		
dbn	ID		
ddw	ID	1	1
dei	ID		
dem	ID		
dij	ID	1	1
diy	ID		
djo	ID	1	1
dkk	ID	1	1
dmr	ID	1	1
dms	ID	1	1
dmu	ID		
dmy	ID		
dna	ID		
dni	ID		
dnk	ID	1	1
dnt	ID		
dnw	ID		
dok	ID	1	1
drn	ID	1	1
dsn	ID	1	1
dun	ID	1	1
dup	ID	1	1
duq	ID	1	1
duv	ID		
duw	ID	1	1
ebc	ID	1	1
eip	ID		
ekg	ID		
emb	ID	1	1
emw	ID	1	1
end	ID	1	1
eno	ID	1	1
enr	ID		
ert	ID		
erw	ID	1	1
etz	ID		
fau	ID		
flh	ID		
frd	ID	1	1
gak	ID		
gal	ID	1	1
gay	ID	1	1
gbi	ID		
gef	ID	1	1
gei	ID	1	1
ges	ID	1	1
gop	ID	1	1
goq	ID	1	1
gor	ID	1	1
grs	ID		
gzn	ID	1	1
had	ID		
hak	ID		
hap	ID		
heg	ID	1	1
hik	ID	1	1
hji	ID		
hmu	ID		
hov	ID		
hrk	ID		
hti	ID		
htu	ID		
hud	ID		
huk	ID		
huw	ID		
hvn	ID		
iba	ID		
ibu	ID		
ihb	ID		
ihp	ID		
ila	ID		
ilu	ID		
imr	ID		
ind	ID	1	1
inl	ID		
ire	ID		
irh	ID		
irx	ID		
ism	ID		
itd	ID		
itx	ID		
iwo	ID		
jal	ID		
jaq	ID	1	1
jau	ID		
jav	ID	1	1
jax	ID		
jbj	ID		
jbr	ID		
jei	ID		
jel	ID		
jet	ID		
jka	ID		
jmd	ID		
jvd	ID		
kaw	ID		
kax	ID		
kbi	ID		
kbv	ID		
kcd	ID		
kdw	ID		
kdy	ID		
kei	ID		
kem	ID		
kgb	ID		
kge	ID		
kgq	ID		
kgr	ID	1	1
kgv	ID		
kgw	ID		
kgx	ID		
khc	ID		
khd	ID		
khe	ID		
khh	ID		
khp	ID		
kig	ID		
kiq	ID		
kiy	ID		
kja	ID		
kjc	ID		
kje	ID		
kjk	ID		
kjr	ID		
kkb	ID		
kkl	ID		
kkv	ID		
kkx	ID		
kli	ID		
klw	ID		
kly	ID		
klz	ID		
kmt	ID		
knd	ID		
knl	ID		
knx	ID		
kod	ID		
kpd	ID		
kpi	ID		
kpq	ID		
kps	ID		
kpu	ID		
kqv	ID		
krz	ID		
ksx	ID		
kti	ID		
kts	ID		
ktt	ID		
kuc	ID		
kuk	ID		
kuv	ID		
kvb	ID		
kvd	ID		
kvh	ID		
kvo	ID		
kvp	ID		
kvr	ID		
kvv	ID		
kvw	ID		
kvz	ID		
kwe	ID		
kwh	ID		
kwr	ID		
kwt	ID		
kxq	ID		
kyd	ID		
kyo	ID		
kyt	ID		
kzb	ID		
kzd	ID		
kzf	ID		
kzi	ID		
kzl	ID		
kzm	ID		
kzp	ID		
kzu	ID		
kzv	ID		
kzx	ID		
kzz	ID		
lau	ID		
law	ID		
lbw	ID		
lbx	ID		
lcc	ID		
lcd	ID		
lce	ID		
lcf	ID		
lcl	ID		
lcq	ID		
lcs	ID		
lev	ID		
lew	ID		
lex	ID		
ley	ID		
lgi	ID		
lhh	ID		
lio	ID		
liw	ID		
lix	ID		
lje	ID		
lji	ID		
ljl	ID		
ljp	ID		
llg	ID		
llm	ID		
llq	ID		
lmf	ID		
lmj	ID		
lmq	ID		
lmr	ID		
lmy	ID		
lnd	ID		
loa	ID		
loe	ID		
lox	ID		
lpe	ID		
lra	ID		
lrn	ID		
lrt	ID		
lti	ID		
ltu	ID		
lur	ID		
lvu	ID		
lwe	ID		
lwt	ID		
mad	ID	1	1
mak	ID		
max	ID		
mdr	ID		
mej	ID		
mfb	ID		
mfp	ID		
mgf	ID		
mgk	ID		
mhp	ID		
mhs	ID		
mhy	ID		
mhz	ID		
min	ID		
mkn	ID		
mky	ID		
mli	ID		
mmb	ID		
mnb	ID		
mnu	ID		
mnx	ID		
mnz	ID		
mog	ID		
mok	ID		
moq	ID		
mpy	ID		
mqa	ID		
mqc	ID		
mqf	ID		
mqg	ID		
mqi	ID		
mqj	ID		
mqn	ID		
mqo	ID		
mqp	ID		
mqr	ID		
mqs	ID		
mqx	ID		
mqy	ID		
mrf	ID		
mrx	ID		
mrz	ID	1	1
msa	ID	1	1
msf	ID		
msg	ID		
msl	ID		
mso	ID		
mss	ID		
mtd	ID		
mtg	ID		
mth	ID		
mtj	ID		
mui	ID		
mvd	ID		
mvp	ID		
mvr	ID		
mvs	ID		
mvv	ID		
mvx	ID		
mwv	ID		
mxd	ID		
mxn	ID		
mxz	ID		
myl	ID		
mzq	ID		
naa	ID		
nae	ID		
nan	ID		
nbn	ID		
nbq	ID		
ndx	ID		
nea	ID		
nec	ID		
ner	ID		
nfa	ID		
nia	ID		
nij	ID		
nil	ID		
nir	ID		
njs	ID		
nkj	ID		
nks	ID		
nlc	ID		
nlk	ID		
nni	ID		
nps	ID		
npy	ID		
nqm	ID		
nsy	ID		
nul	ID		
nxe	ID		
nxg	ID		
nxl	ID		
nxr	ID		
nxu	ID		
nxx	ID		
oia	ID		
omy	ID		
oni	ID		
onx	ID		
opk	ID		
orz	ID		
osi	ID		
osn	ID		
otd	ID		
pas	ID		
pdn	ID		
pdo	ID		
pea	ID		
pee	ID		
pel	ID		
pey	ID		
pgu	ID		
pku	ID		
ple	ID		
plh	ID		
pmf	ID		
pmo	ID		
pmy	ID		
pnc	ID		
pni	ID		
pnp	ID		
pns	ID		
ppk	ID		
ppm	ID		
pru	ID		
psa	ID		
pse	ID		
psn	ID		
ptn	ID		
ptt	ID		
ptu	ID		
puc	ID		
pud	ID		
puf	ID		
puj	ID		
put	ID		
rac	ID		
ran	ID		
raz	ID		
reb	ID		
rej	ID		
ret	ID		
rgu	ID		
rir	ID		
riu	ID		
rjg	ID		
rmh	ID		
rmm	ID		
rnn	ID		
rob	ID		
ror	ID		
row	ID		
rth	ID		
saj	ID		
sao	ID	1	1
sas	ID	1	1
sau	ID		
saw	ID		
sbg	ID		
sbr	ID		
sbt	ID		
sbx	ID		
scg	ID		
sda	ID		
sdo	ID		
sdq	ID		
sdu	ID		
set	ID		
seu	ID		
sge	ID		
sgu	ID		
sjb	ID		
skh	ID		
ski	ID		
sko	ID		
skv	ID		
skx	ID		
skz	ID		
slg	ID		
slp	ID		
slu	ID		
sly	ID		
slz	ID		
smr	ID		
smw	ID		
snu	ID		
snv	ID		
sob	ID		
sow	ID		
spb	ID		
spi	ID		
spr	ID		
sre	ID		
srl	ID		
srt	ID		
srw	ID		
ssq	ID		
ste	ID		
sun	ID	1	1
sve	ID		
swr	ID		
sws	ID		
swt	ID		
swu	ID		
sxn	ID		
sya	ID		
szb	ID		
szn	ID		
szp	ID		
szw	ID		
tad	ID		
tbp	ID		
tby	ID		
tcg	ID		
tcm	ID		
tcq	ID		
tdi	ID		
tdj	ID		
tdn	ID		
tds	ID		
tdt	ID		
tes	ID		
tet	ID		
tev	ID		
tfo	ID		
tft	ID		
tip	ID		
tjg	ID		
tkx	ID		
tlb	ID		
tld	ID		
tlg	ID		
tlk	ID		
tln	ID		
tlt	ID		
tlu	ID		
tlv	ID		
tmg	ID		
tmj	ID		
tml	ID		
tmn	ID		
tmu	ID		
tni	ID		
tnm	ID		
tnt	ID		
tnw	ID		
tom	ID		
toy	ID		
tpf	ID		
tpg	ID		
tre	ID		
trt	ID		
tsg	ID		
tti	ID		
ttn	ID		
ttp	ID		
tty	ID		
tuj	ID		
tve	ID		
tvm	ID		
tvo	ID		
tvw	ID		
twe	ID		
twg	ID		
twu	ID		
twy	ID		
txe	ID		
txm	ID		
txn	ID		
txq	ID		
txs	ID		
txt	ID		
tyn	ID		
tzn	ID		
udj	ID		
ues	ID		
uhn	ID		
uka	ID		
ulf	ID		
ulm	ID		
ulu	ID		
ums	ID		
unz	ID		
urn	ID		
ury	ID		
vbb	ID		
vkk	ID		
vkl	ID		
vko	ID		
vkt	ID		
vme	ID		
vms	ID		
vto	ID		
wad	ID		
wah	ID		
wai	ID		
wbb	ID		
wbe	ID		
wbw	ID		
weo	ID		
wet	ID		
wew	ID		
wfg	ID		
wgo	ID		
wha	ID		
whk	ID		
whu	ID		
wkd	ID		
wli	ID		
wlo	ID		
wlw	ID		
wmm	ID		
wms	ID		
wng	ID		
wnk	ID		
wno	ID		
wod	ID		
woi	ID		
woo	ID		
wor	ID		
wow	ID		
wrp	ID		
wrs	ID		
wru	ID		
wrx	ID		
wsa	ID		
wtw	ID		
wul	ID		
wuy	ID		
xau	ID		
xay	ID		
xbr	ID		
xdy	ID		
xem	ID		
xkd	ID		
xke	ID		
xkl	ID		
xkn	ID		
xkq	ID		
xks	ID		
xkw	ID		
xky	ID		
xmm	ID		
xmt	ID		
xmx	ID		
xmz	ID		
xod	ID		
xse	ID		
xte	ID		
xwr	ID		
xxk	ID		
xxt	ID		
yac	ID		
yet	ID		
yir	ID		
yki	ID		
yli	ID		
ymn	ID		
yrs	ID		
yue	ID		
yva	ID		
zbt	ID		
zho	ID	0	0
zka	ID		
zlm	ID		
zrs	ID		
eng	IE	0	1
fra	IE	0	0
gle	IE		
isg	IE		
mga	IE		
pgl	IE		
sga	IE		
sth	IE		
yol	IE		
aij	IL	0	1
aju	IL	0	1
amh	IL	0	0
apc	IL	1	1
ara	IL	0	1
bhh	IL		
bjf	IL	0	1
eng	IL	0	0
fra	IL	0	0
hbo	IL	1	1
heb	IL	1	1
hun	IL		
huy	IL	0	1
isr	IL		
jbe	IL		
jdt	IL		
jge	IL		
jpr	IL		
jrb	IL	1	1
jye	IL	0	1
lad	IL		
lsd	IL	0	1
mal	IL		
pol	IL		
ron	IL	0	0
rus	IL		
smp	IL	1	1
sqx	IL		
syy	IL		
tir	IL	0	0
trg	IL	1	1
xdm	IL	1	1
ydd	IL		
yej	IL		
yhd	IL	0	1
yid	IL		
yih	IL		
yud	IL	1	1
eng	IM	0	1
glv	IM		
aaf	IN		
abj	IN		
aci	IN		
ack	IN		
acl	IN		
adi	IN		
adl	IN		
agi	IN		
aho	IN		
ahr	IN		
aim	IN		
aio	IN		
ajz	IN	1	1
akj	IN	1	1
akm	IN		
akx	IN		
aky	IN		
all	IN		
aml	IN	1	1
anm	IN		
anp	IN		
anq	IN		
anr	IN		
aot	IN		
apq	IN		
apt	IN		
ara	IN	0	1
asm	IN	1	1
asr	IN	1	1
awa	IN	1	1
bal	IN		
bap	IN		
bdv	IN		
bee	IN		
ben	IN	1	1
bfb	IN		
bfq	IN		
bfr	IN		
bft	IN		
bfu	IN		
bfw	IN	1	1
bfy	IN		
bfz	IN		
bgc	IN	1	1
bgd	IN		
bge	IN		
bgg	IN		
bgp	IN		
bgq	IN		
bgr	IN		
bgw	IN		
bha	IN		
bhb	IN	1	1
bhd	IN		
bhi	IN		
bho	IN	1	1
bht	IN		
bhu	IN		
bhx	IN		
biu	IN		
bix	IN	1	1
biy	IN	1	1
bjj	IN		
bkk	IN		
bns	IN		
bod	IN		
bpx	IN		
bpy	IN		
bra	IN		
brw	IN		
brx	IN		
btv	IN		
caq	IN	1	1
ccp	IN		
cde	IN		
cdf	IN		
cdh	IN		
cdi	IN		
cdj	IN		
cdn	IN		
cdz	IN	1	1
cfm	IN		
cih	IN		
cik	IN		
clk	IN		
cls	IN		
cna	IN		
cnh	IN		
cnk	IN		
crv	IN	1	1
ctd	IN		
ctt	IN		
cty	IN		
cvg	IN		
daq	IN		
dcc	IN	1	1
der	IN		
dgo	IN		
dhd	IN		
dhi	IN		
dhn	IN		
dho	IN		
dis	IN		
div	IN		
dln	IN		
doi	IN		
drd	IN		
dso	IN		
dty	IN		
dub	IN		
duh	IN		
dwk	IN		
dzo	IN		
emu	IN		
eng	IN	0	0
era	IN		
esg	IN		
fmu	IN		
fra	IN	0	0
gac	IN		
gaq	IN	1	1
gas	IN		
gau	IN		
gbj	IN	1	1
gbk	IN		
gbl	IN		
gbm	IN		
gda	IN		
gdb	IN		
gdx	IN		
gjk	IN		
gju	IN		
gnb	IN		
gno	IN		
goj	IN		
gok	IN		
gom	IN		
gon	IN		
gra	IN		
gro	IN		
grt	IN		
guj	IN	1	1
gvr	IN		
haj	IN		
hca	IN		
hii	IN		
hin	IN	1	1
hkh	IN		
hlb	IN		
hlt	IN		
hmr	IN		
hne	IN	1	1
hoc	IN	1	1
hoj	IN		
hoy	IN		
hra	IN		
hru	IN		
idb	IN		
ima	IN		
ins	IN		
iru	IN		
jda	IN		
jkr	IN		
jmn	IN		
jna	IN		
jnl	IN		
jns	IN		
jun	IN	1	1
juy	IN	1	1
kan	IN	1	1
kas	IN		
kbg	IN		
kdq	IN		
kej	IN		
kep	IN		
keq	IN		
kev	IN		
kex	IN		
key	IN		
kfa	IN		
kfb	IN		
kfc	IN		
kfd	IN		
kfe	IN		
kff	IN		
kfg	IN		
kfh	IN		
kfi	IN		
kfk	IN		
kfp	IN	1	1
kfq	IN	1	1
kfr	IN		
kfs	IN		
kft	IN		
kfu	IN		
kfv	IN		
kfw	IN		
kfx	IN		
kfy	IN		
kha	IN	1	1
khn	IN		
khr	IN	1	1
kht	IN		
khw	IN		
kix	IN		
kjo	IN		
kkf	IN		
kle	IN		
klr	IN		
kmj	IN		
kmm	IN		
knn	IN		
kok	IN		
kpb	IN		
kru	IN		
ksu	IN		
ksy	IN		
ksz	IN	1	1
kwx	IN		
kxp	IN		
kxu	IN		
kxv	IN		
kyw	IN		
lae	IN		
lah	IN	1	1
lax	IN		
lbf	IN		
lbj	IN		
lbm	IN		
lep	IN		
lhl	IN		
lhm	IN		
lif	IN		
lis	IN		
lmk	IN		
lmn	IN		
lsh	IN		
lus	IN		
lyg	IN	1	1
mag	IN	1	1
mai	IN	1	1
mal	IN	1	1
mar	IN	1	1
mgp	IN		
mha	IN		
mhu	IN		
mjl	IN		
mjo	IN		
mjp	IN		
mjq	IN		
mjr	IN		
mjt	IN		
mju	IN		
mjv	IN		
mjw	IN		
mjx	IN	1	1
mjz	IN		
mkb	IN		
mke	IN		
mki	IN		
mmj	IN	1	1
mmk	IN		
mni	IN		
mrg	IN		
mrh	IN		
mro	IN		
mrr	IN		
mtr	IN		
muk	IN		
mup	IN		
mut	IN		
muv	IN		
mwr	IN	1	1
mxj	IN		
nag	IN		
nbc	IN		
nbe	IN		
nbg	IN		
nbi	IN		
nbt	IN		
nbu	IN		
ncb	IN	1	1
nct	IN		
nef	IN		
nep	IN		
nes	IN		
new	IN		
nhh	IN		
nik	IN	1	1
nit	IN		
njb	IN		
njh	IN		
njm	IN		
njn	IN		
njo	IN		
njz	IN		
nkb	IN		
nkd	IN		
nkf	IN		
nkh	IN		
nki	IN		
nll	IN		
nlx	IN		
nma	IN		
nme	IN		
nmf	IN		
nmh	IN		
nmo	IN		
nng	IN		
nnl	IN		
nnp	IN		
noe	IN		
noi	IN		
nph	IN		
npi	IN		
npo	IN		
npu	IN		
nre	IN		
nri	IN		
nrr	IN		
nsa	IN		
nsm	IN		
nst	IN		
nzm	IN		
odk	IN		
okj	IN		
ola	IN		
omp	IN		
omr	IN		
onp	IN		
oon	IN		
ori	IN	1	1
ort	IN		
ory	IN	1	1
oty	IN		
pan	IN	1	1
pbu	IN		
pbv	IN	1	1
pcf	IN		
pcg	IN		
pch	IN		
pci	IN		
pcj	IN	1	1
pck	IN		
pcl	IN		
peg	IN		
pgg	IN		
phd	IN		
phj	IN		
phk	IN		
phr	IN		
pka	IN	1	1
pkh	IN		
pkr	IN		
pli	IN		
pmh	IN		
pmx	IN		
pnb	IN		
por	IN		
prx	IN		
psu	IN		
ptq	IN		
pty	IN		
pub	IN		
pus	IN		
pwr	IN		
rab	IN		
rah	IN		
raj	IN	1	1
ral	IN		
raw	IN		
rei	IN		
rgk	IN		
ria	IN		
rjs	IN		
rki	IN		
rkt	IN		
rmz	IN		
rnl	IN		
rnp	IN		
rtw	IN		
ruh	IN		
rwr	IN		
san	IN		
sat	IN	1	1
saz	IN		
sbu	IN		
sch	IN		
sck	IN		
scl	IN		
scu	IN		
sdp	IN		
sgj	IN		
sgp	IN		
shl	IN		
sii	IN		
sip	IN		
sjl	IN		
sjp	IN		
skr	IN		
sle	IN		
smt	IN		
smv	IN		
snd	IN		
spt	IN		
spv	IN		
srb	IN	1	1
srx	IN		
ssi	IN		
ssk	IN		
std	IN		
suv	IN		
suz	IN		
swv	IN		
syl	IN		
taj	IN		
tam	IN	1	1
tcx	IN		
tcy	IN		
tcz	IN		
tdb	IN		
tdh	IN		
tef	IN	1	1
tel	IN	1	1
tgj	IN		
the	IN		
thf	IN		
thl	IN		
thn	IN		
thq	IN		
thr	IN		
tkb	IN		
tkt	IN		
tpe	IN		
tpq	IN		
trd	IN	1	1
tro	IN		
trp	IN		
try	IN		
tsj	IN		
tvt	IN		
twm	IN		
txo	IN		
udg	IN		
uki	IN		
ull	IN		
unr	IN	1	1
unx	IN		
urd	IN	1	1
url	IN		
vaa	IN		
vah	IN		
vap	IN		
vas	IN		
vav	IN		
vis	IN		
vjk	IN		
vkp	IN		
vmd	IN		
vsn	IN		
wbq	IN		
wbr	IN		
wbs	IN		
wkb	IN		
wkl	IN		
wku	IN		
wry	IN		
wsg	IN		
wtm	IN		
xac	IN		
xis	IN		
xnr	IN		
xns	IN		
xsr	IN		
xtr	IN		
xua	IN		
xub	IN		
xuj	IN		
ybh	IN		
yea	IN		
yeu	IN		
yim	IN		
ymr	IN		
zau	IN		
zkr	IN		
zom	IN		
zrg	IN		
zyp	IN		
eng	IO	0	0
acm	IQ	1	1
aii	IQ	1	1
aij	IQ	1	1
akk	IQ	1	1
ara	IQ	0	1
arc	IQ	1	1
ayp	IQ	1	1
aze	IQ	1	1
bjf	IQ	1	1
bjm	IQ		
ckb	IQ		
cld	IQ	1	1
eng	IQ	0	0
fas	IQ	0	1
huy	IQ	1	1
kqd	IQ	1	1
kur	IQ		
lrc	IQ		
lsd	IQ	1	1
sdb	IQ		
sdf	IQ		
sux	IQ		
syr	IQ	1	1
tmr	IQ	1	1
xlu	IQ		
yhd	IQ	1	1
acm	IR	1	1
afb	IR	1	1
aii	IR	1	1
aij	IR	1	1
aiq	IR		
ara	IR	0	1
arb	IR	0	1
arc	IR	0	1
atn	IR		
avd	IR		
ave	IR		
azb	IR	1	1
aze	IR	1	1
bal	IR		
bcc	IR		
bgn	IR		
bqi	IR		
brh	IR		
bsg	IR		
ckb	IR		
def	IR		
elx	IR		
esh	IR	1	1
fas	IR	1	1
fay	IR	1	1
faz	IR		
gbz	IR		
glk	IR		
goz	IR		
gzi	IR		
hac	IR		
haz	IR		
hrz	IR		
huy	IR	1	1
hye	IR		
jdg	IR		
jpr	IR		
kaa	IR	0	1
kat	IR		
kaz	IR	0	1
kfm	IR		
kgn	IR		
kho	IR		
klj	IR	1	1
kmr	IR		
kmz	IR	1	1
ktl	IR		
kur	IR		
lki	IR		
lrc	IR		
lrl	IR		
lsa	IR		
luz	IR		
mid	IR	1	1
myz	IR	1	1
mzn	IR		
ntz	IR		
nyq	IR		
okh	IR		
pal	IR		
pbt	IR		
peo	IR		
pes	IR	1	1
prd	IR		
prs	IR		
psc	IR		
pus	IR		
qxq	IR	1	1
rat	IR		
rdb	IR		
rmn	IR		
rmt	IR		
rom	IR	0	1
sdh	IR		
sgr	IR		
shm	IR		
siy	IR		
smy	IR		
soj	IR		
sqo	IR		
srz	IR		
syn	IR	1	1
syr	IR	0	1
tks	IR		
tly	IR		
tov	IR		
ttt	IR		
tuk	IR	1	1
vaf	IR		
vmh	IR		
xkc	IR		
xkj	IR		
xkp	IR		
xly	IR		
xme	IR		
xmn	IR		
xpr	IR		
xtq	IR		
zum	IR		
dan	IS		
icl	IS		
isl	IS		
aae	IT		
cat	IT		
cim	IT		
cms	IT		
deu	IT		
egl	IT		
ell	IT		
eng	IT	0	0
ett	IT		
fra	IT	0	1
frp	IT		
fur	IT		
hbs	IT		
hrv	IT		
ims	IT		
ise	IT		
ita	IT	1	1
itk	IT		
lij	IT		
lld	IT		
lmo	IT		
mhn	IT		
nap	IT		
nrp	IT		
osc	IT		
pgn	IT		
pms	IT		
rgn	IT		
sbv	IT		
scn	IT		
scx	IT		
sdc	IT		
sdn	IT		
slv	IT		
spa	IT	0	0
spx	IT		
sqi	IT		
sqr	IT	1	1
src	IT		
srd	IT		
sro	IT		
svm	IT		
sxc	IT		
umc	IT		
vec	IT		
xae	IT		
xcc	IT		
xcg	IT		
xfa	IT		
xhr	IT		
xlg	IT		
xlp	IT		
xrr	IT		
xum	IT		
xve	IT		
xvo	IT		
xvs	IT		
eng	JE	0	1
nrf	JE		
eng	JM	0	0
jam	JM		
jcs	JM		
jls	JM		
apc	JO	1	1
ara	JO	1	1
arc	JO	1	1
avl	JO	1	1
eng	JO	0	0
jos	JO		
obm	JO	1	1
xdm	JO	1	1
ain	JP	1	1
ams	JP		
ehs	JP		
jks	JP		
jpn	JP	1	1
jsl	JP		
kor	JP		
kzg	JP		
mvi	JP		
ojp	JP		
okn	JP		
ryn	JP		
rys	JP		
ryu	JP		
tkn	JP		
xug	JP		
yoi	JP		
yox	JP		
ara	KE	0	1
bob	KE	1	1
bxk	KE		
coh	KE		
cuh	KE		
dal	KE	1	1
dav	KE		
dig	KE		
dsh	KE	1	1
dug	KE		
ebu	KE		
elo	KE	1	1
enb	KE		
eng	KE	0	0
eyo	KE		
guj	KE		
guz	KE		
ida	KE		
kam	KE		
kik	KE		
kln	KE		
lah	KE		
lkb	KE		
lko	KE		
lks	KE		
lri	KE		
lrm	KE		
lto	KE		
lts	KE		
luo	KE		
luy	KE		
lwg	KE		
mas	KE		
mer	KE		
mlk	KE		
muu	KE	1	1
mws	KE		
niq	KE		
nle	KE		
nyd	KE		
nyf	KE		
oki	KE		
omt	KE		
orc	KE	1	1
orm	KE	1	1
pan	KE		
pkb	KE		
pko	KE		
rag	KE		
rel	KE	1	1
saq	KE	1	1
sgc	KE		
sgm	KE		
som	KE	1	1
spy	KE		
ssn	KE	1	1
swa	KE	1	1
sxb	KE		
tec	KE		
teo	KE		
tga	KE		
thk	KE		
tuv	KE		
tuy	KE		
tvs	KE		
xki	KE		
dng	KG		
kaa	KG	0	1
kaz	KG	1	1
kir	KG	1	1
rus	KG		
tat	KG	0	1
tgk	KG		
uig	KG	0	1
uzb	KG	1	1
xqa	KG	1	1
zho	KG	0	1
brb	KH	1	1
cja	KH	1	1
csx	KH		
fra	KH	0	0
hkn	KH	1	1
jra	KH		
kdt	KH	1	1
khm	KH	1	1
krr	KH	1	1
krv	KH	1	1
okz	KH	1	1
pcb	KH	1	1
rka	KH	1	1
scq	KH	1	1
smu	KH	1	1
sxm	KH		
syo	KH	1	1
tpu	KH	1	1
vie	KH	1	1
xhm	KH	1	1
xkk	KH	1	1
zho	KH	0	0
eng	KI	0	0
gil	KI	1	1
ara	KM	0	1
fra	KM	0	0
wlc	KM		
wni	KM		
zdj	KM		
eng	KN	0	0
hmk	KP		
kor	KP	1	1
zkg	KP		
hmk	KR		
jje	KR		
kor	KR	1	1
kvk	KR		
okm	KR		
oko	KR		
pkc	KR		
xpp	KR		
zra	KR		
afb	KW	1	1
ara	KW	0	1
eng	KY	0	0
fil	KY	0	0
spa	KY	0	0
deu	KZ		
eng	KZ	0	0
kaa	KZ	0	1
kaz	KZ	1	1
rus	KZ	0	0
uig	KZ	1	1
aem	LA	1	1
alk	LA	1	1
bgl	LA	1	1
brv	LA	1	1
cno	LA		
fra	LA	0	0
hmn	LA		
hnj	LA		
hnu	LA	1	1
irr	LA		
kdt	LA	1	1
khf	LA	1	1
kjg	LA	1	1
kuf	LA	1	1
lao	LA		
lbg	LA		
lbn	LA	1	1
lbo	LA	1	1
lso	LA		
lvi	LA	1	1
mlf	LA	1	1
mww	LA		
ncq	LA	1	1
nev	LA	1	1
ngt	LA	1	1
oog	LA	1	1
oyb	LA	1	1
pho	LA		
phq	LA		
pnx	LA	1	1
sct	LA	1	1
spu	LA	1	1
sqq	LA	1	1
sss	LA	1	1
tdd	LA		
tdf	LA	1	1
tgr	LA		
thi	LA		
thm	LA	1	1
tnu	LA		
tth	LA	1	1
tto	LA	1	1
uan	LA		
xko	LA		
ycp	LA		
apc	LB	1	1
ara	LB	0	1
eng	LB	0	0
fra	LB	0	0
hye	LB		
kur	LB		
phn	LB	1	1
acf	LC		
eng	LC	0	0
fra	LC	0	0
deu	LI		
eng	LI	0	0
gsw	LI		
hbs	LI		
ita	LI		
por	LI		
spa	LI	0	0
srp	LI		
tur	LI	0	0
wae	LI		
eng	LK	0	0
pli	LK		
sci	LK		
sin	LK	1	1
sqs	LK		
tam	LK		
ved	LK		
blh	LR		
bsq	LR		
bza	LR		
dee	LR		
dnj	LR		
eng	LR	0	0
ful	LR		
gbo	LR		
gec	LR		
ggb	LR		
glr	LR		
gol	LR		
grb	LR		
grj	LR		
grv	LR		
gry	LR		
klu	LR		
kpe	LR		
kqo	LR		
krn	LR		
krw	LR		
kss	LR		
lir	LR		
lom	LR		
man	LR		
men	LR		
mev	LR		
mnk	LR		
mzj	LR		
oub	LR		
tja	LR		
vai	LR		
xpe	LR		
eng	LS	0	0
sot	LS		
ssw	LS		
xho	LS		
zul	LS		
bel	LT		
deu	LT		
eng	LT	0	0
fra	LT	0	0
kdr	LT	0	1
lav	LT		
lit	LT		
lls	LT		
olt	LT		
pol	LT		
rus	LT	0	0
sgs	LT		
svx	LT		
sxl	LT		
xcu	LT		
xzm	LT		
deu	LU		
eng	LU	0	0
fra	LU	0	1
ltz	LU		
por	LU		
eng	LV	0	0
fra	LV	0	0
lav	LV		
liv	LV		
lsl	LV		
ltg	LV		
lvs	LV		
rom	LV	0	0
rus	LV	0	0
sxl	LV		
xcu	LV		
xzm	LV		
zkv	LV		
ara	LY	0	1
arb	LY	0	1
auj	LY	1	1
ayl	LY	1	1
gha	LY	1	1
jbn	LY	1	1
lbs	LY		
rmt	LY		
siz	LY	1	1
swn	LY	1	1
thv	LY	1	1
tmh	LY	1	1
aju	MA	1	1
ara	MA	0	1
arb	MA	0	1
ary	MA	1	1
eng	MA	0	0
fra	MA	0	0
gho	MA	1	1
grr	MA	1	1
jrb	MA	0	1
mey	MA	1	1
rif	MA	1	1
shi	MA	1	1
sjs	MA	1	1
spa	MA	0	0
tzm	MA	1	1
xms	MA		
zgh	MA	1	1
fra	MC	0	1
bul	MD		
fra	MD	0	0
gag	MD	1	1
rom	MD	0	1
ron	MD	1	1
rus	MD	0	0
ukr	MD		
vsi	MD		
bos	ME		
cnr	ME		
fra	ME	0	0
hbs	ME		
hrv	ME		
rom	ME	0	1
sqi	ME		
srp	ME		
fra	MF	0	0
bhr	MG	1	1
bmm	MG	1	1
bzc	MG	1	1
eng	MG	0	0
fra	MG	0	0
mlg	MG	1	1
msh	MG		
mzc	MG		
plt	MG		
skg	MG		
tdx	MG		
tkg	MG		
txy	MG		
xmv	MG		
xmw	MG		
eng	MH	0	0
mah	MH		
bos	MK		
fra	MK	0	0
hbs	MK		
mkd	MK		
rom	MK	0	1
rup	MK		
sqi	MK		
srp	MK		
tur	MK	0	0
aqd	ML		
ara	ML	0	1
bam	ML	1	1
bmq	ML		
bog	ML		
boo	ML		
boz	ML		
bxw	ML		
bze	ML		
bzx	ML		
dba	ML		
dbg	ML		
dbt	ML		
dbu	ML		
dbw	ML		
dds	ML		
dgb	ML		
dje	ML		
djm	ML		
dmb	ML		
dsq	ML		
dti	ML		
dtk	ML		
dtm	ML		
dto	ML		
dts	ML		
dtt	ML		
dtu	ML		
dux	ML		
dym	ML		
ffm	ML		
fra	ML	0	0
ful	ML		
hmb	ML		
jow	ML		
kao	ML		
khq	ML		
man	ML		
mey	ML	1	1
mwk	ML		
myk	ML		
nzz	ML		
rkm	ML		
ses	ML		
shz	ML		
snk	ML		
spp	ML		
taq	ML	1	1
tde	ML		
tmh	ML	1	1
tst	ML		
tsy	ML		
ttq	ML	1	1
xkg	ML		
acn	MM		
aeu	MM		
ahk	MM		
anl	MM		
anm	MM		
atb	MM		
bgr	MM		
blk	MM		
blr	MM	1	1
bwe	MM		
cbl	MM		
ccp	MM		
cek	MM		
cey	MM		
cfm	MM		
ckh	MM		
ckn	MM		
clj	MM		
clt	MM		
cmn	MM	0	1
cmr	MM		
cnb	MM		
cnh	MM		
cnk	MM		
cnw	MM		
csh	MM		
csj	MM		
csv	MM		
csy	MM		
ctd	MM		
cth	MM		
czt	MM		
dao	MM		
dnu	MM	1	1
dnv	MM		
duu	MM		
eky	MM		
ghk	MM		
hlt	MM		
hmn	MM		
hnj	MM		
hpo	MM		
int	MM		
jkm	MM		
jkp	MM		
jmn	MM		
kac	MM		
khb	MM		
khg	MM		
kht	MM		
kix	MM		
kjp	MM		
kkh	MM		
ksw	MM		
kvl	MM		
kvq	MM		
kvt	MM		
kvu	MM		
kvy	MM		
kxf	MM		
kxk	MM		
kyu	MM		
lhi	MM		
lhu	MM		
lis	MM		
lpn	MM		
lsi	MM		
lus	MM		
lzn	MM		
mhx	MM		
mnw	MM	1	1
mqt	MM	1	1
mrh	MM		
mro	MM		
mwq	MM		
mwt	MM		
mya	MM	1	1
nbe	MM		
nlq	MM		
npg	MM		
nqq	MM		
nqy	MM		
nst	MM		
ntx	MM		
nuf	MM		
nun	MM		
nxk	MM		
obr	MM		
omx	MM	1	1
pce	MM	1	1
pdu	MM		
pli	MM		
pll	MM	1	1
prk	MM	1	1
pwo	MM		
pyx	MM		
pyy	MM		
pzn	MM		
raw	MM		
rbb	MM	1	1
rhg	MM		
ril	MM	1	1
rki	MM		
rmz	MM		
rtc	MM		
sez	MM		
shn	MM		
stu	MM	1	1
tcl	MM		
tco	MM		
tcp	MM		
tcz	MM		
tdd	MM		
tjl	MM		
tlq	MM	1	1
tvn	MM		
ukk	MM	1	1
umn	MM		
wbm	MM	1	1
wea	MM		
weu	MM		
yin	MM	1	1
ysm	MM		
zho	MM	0	1
zkd	MM		
zkn	MM		
zom	MM		
zyp	MM		
bua	MN		
bxm	MN		
cmg	MN		
kaz	MN	0	1
khk	MN		
mon	MN		
msr	MN		
otk	MN		
rus	MN	0	0
uig	MN	0	1
xng	MN		
ykh	MN		
zho	MN	0	1
cmn	MO		
eng	MO	0	0
fil	MO	0	0
nan	MO		
por	MO		
tgl	MO		
yue	MO		
zho	MO	1	1
cal	MP	1	1
cha	MP	1	1
eng	MP	0	0
fil	MP	0	0
tpv	MP		
zho	MP	0	0
fra	MQ	0	0
ara	MR	0	1
arb	MR	0	1
fra	MR	0	0
fuc	MR		
ful	MR		
mey	MR	1	1
snk	MR		
wol	MR		
zen	MR	1	1
eng	MS	0	0
ara	MT	0	1
deu	MT		
eng	MT	0	0
fra	MT	0	0
ita	MT		
mdl	MT		
mlt	MT	1	1
ben	MU		
bho	MU		
eng	MU	0	0
fra	MU	0	0
hin	MU		
lsy	MU		
mar	MU		
mfe	MU		
tam	MU		
tel	MU		
urd	MU		
zho	MU	0	0
div	MV		
eng	MV	0	0
eng	MW	0	0
kzn	MW		
lai	MW		
lon	MW		
lws	MW		
nkv	MW		
nya	MW	1	1
nyr	MW		
nyy	MW		
swk	MW		
tog	MW		
tum	MW		
yao	MW		
zul	MW		
afs	MX		
agu	MX		
amu	MX		
apc	MX	0	0
ara	MX	0	0
azd	MX		
azg	MX		
azm	MX		
azn	MX		
azz	MX		
cac	MX		
cco	MX		
chd	MX		
chf	MX		
chj	MX		
chq	MX		
chz	MX		
cip	MX		
cle	MX		
clo	MX		
cly	MX		
cnl	MX		
cnt	MX		
cob	MX		
coc	MX		
coj	MX		
cok	MX		
coz	MX		
cpa	MX		
crn	MX		
csa	MX		
cso	MX		
cta	MX		
cte	MX		
ctl	MX		
ctp	MX		
ctu	MX		
ctz	MX		
cuc	MX		
cut	MX		
cux	MX		
cuy	MX		
cvn	MX		
cya	MX		
czn	MX		
dih	MX		
emm	MX		
emy	MX		
eng	MX	0	0
eud	MX		
fra	MX	0	0
hch	MX		
hue	MX		
hus	MX		
huv	MX		
hve	MX		
hvv	MX		
ixc	MX		
jac	MX		
jmx	MX		
kic	MX		
klb	MX		
knj	MX		
lac	MX		
lsc	MX		
maa	MX		
mab	MX		
maj	MX		
mam	MX		
maq	MX		
mat	MX		
mau	MX		
maz	MX		
mbz	MX		
mce	MX		
mco	MX		
mdv	MX		
meh	MX		
mfs	MX		
mfy	MX		
mhc	MX		
mib	MX		
mie	MX		
mig	MX		
mih	MX		
mii	MX		
mil	MX		
mim	MX		
mio	MX		
mip	MX		
mir	MX		
mit	MX		
miu	MX		
mix	MX		
miy	MX		
miz	MX		
mjc	MX		
mks	MX		
mmc	MX		
mpm	MX		
mqh	MX		
msd	MX		
mto	MX		
mtu	MX		
mtx	MX		
mvg	MX		
mxa	MX		
mxb	MX		
mxp	MX		
mxq	MX		
mxs	MX		
mxt	MX		
mxv	MX		
mxy	MX		
mza	MX		
mzi	MX		
mzl	MX		
naz	MX		
nch	MX		
nci	MX		
ncj	MX		
ncl	MX		
ncx	MX		
neq	MX		
ngu	MX		
nhc	MX		
nhe	MX		
nhg	MX		
nhi	MX		
nhk	MX		
nhm	MX		
nhn	MX		
nhp	MX		
nhq	MX		
nht	MX		
nhv	MX		
nhw	MX		
nhx	MX		
nhy	MX		
nhz	MX		
nlv	MX		
npl	MX		
nsu	MX		
ntp	MX		
nuz	MX		
ocu	MX		
ood	MX		
opt	MX		
ote	MX		
otl	MX		
otm	MX		
otn	MX		
otq	MX		
ots	MX		
ott	MX		
otx	MX		
otz	MX		
pbe	MX		
pbf	MX		
pbm	MX		
pbs	MX		
pca	MX		
pdt	MX		
pei	MX		
pia	MX		
plo	MX		
pls	MX		
pmq	MX		
pmz	MX		
poe	MX		
poi	MX		
poq	MX		
pos	MX		
pow	MX		
ppi	MX		
pps	MX		
pua	MX		
pxm	MX		
rmy	MX		
rom	MX	0	0
sei	MX		
spa	MX	0	0
stp	MX		
tac	MX		
tar	MX		
tbu	MX		
tcf	MX		
tcu	MX		
tcw	MX		
tee	MX		
tep	MX		
thh	MX		
tku	MX		
tla	MX		
tlc	MX		
tlp	MX		
toc	MX		
toj	MX		
too	MX		
top	MX		
tos	MX		
tpc	MX		
tpl	MX		
tpp	MX		
tpt	MX		
tpx	MX		
tqt	MX		
trc	MX		
trq	MX		
trs	MX		
tsz	MX		
ttc	MX		
twr	MX		
tzh	MX		
tzo	MX		
var	MX		
vec	MX		
vmc	MX		
vmj	MX		
vmm	MX		
vmp	MX		
vmq	MX		
vmx	MX		
vmy	MX		
vmz	MX		
xcm	MX		
xcn	MX		
xcw	MX		
xep	MX		
xgr	MX		
xpo	MX		
xso	MX		
xta	MX		
xtb	MX		
xtd	MX		
xti	MX		
xtj	MX		
xtl	MX		
xtm	MX		
xtn	MX		
xtp	MX		
xts	MX		
xtt	MX		
xtu	MX		
xty	MX		
xzp	MX		
yaq	MX		
yua	MX		
zaa	MX		
zab	MX		
zac	MX		
zad	MX		
zae	MX		
zaf	MX		
zai	MX		
zam	MX		
zao	MX		
zap	MX		
zaq	MX		
zar	MX		
zas	MX		
zat	MX		
zav	MX		
zaw	MX		
zax	MX		
zca	MX		
zcd	MX		
zoc	MX		
zoh	MX		
zoo	MX		
zoq	MX		
zor	MX		
zos	MX		
zpa	MX		
zpb	MX		
zpc	MX		
zpd	MX		
zpe	MX		
zpf	MX		
zpg	MX		
zph	MX		
zpi	MX		
zpj	MX		
zpk	MX		
zpl	MX		
zpm	MX		
zpn	MX		
zpo	MX		
zpp	MX		
zpq	MX		
zpr	MX		
zps	MX		
zpt	MX		
zpu	MX		
zpv	MX		
zpw	MX		
zpx	MX		
zpy	MX		
zpz	MX		
zsr	MX		
zte	MX		
ztg	MX		
ztl	MX		
ztm	MX		
ztn	MX		
ztp	MX		
ztq	MX		
zts	MX		
ztt	MX		
ztu	MX		
ztx	MX		
zty	MX		
abf	MY	1	1
bdg	MY	1	1
bdr	MY	1	1
bjn	MY	0	0
blg	MY		
bnb	MY	1	1
bny	MY	1	1
bsy	MY	1	1
bth	MY	1	1
btq	MY	1	1
bug	MY	0	0
ccm	MY	1	1
cdo	MY		
cmn	MY	0	1
cwg	MY	1	1
dbj	MY	1	1
dkr	MY	1	1
dmg	MY	1	1
dmv	MY	1	1
dpp	MY	1	1
drg	MY	1	1
dro	MY	1	1
dtb	MY	1	1
dtp	MY	1	1
dtr	MY	1	1
dup	MY	1	1
eng	MY	0	0
gnq	MY	1	1
grm	MY	1	1
hak	MY		
iba	MY		
ilm	MY		
jah	MY	1	1
jak	MY		
jav	MY		
jhi	MY	1	1
kag	MY		
kgi	MY		
knq	MY	1	1
kns	MY	1	1
kqr	MY		
kqt	MY		
kve	MY		
kxd	MY		
kxi	MY		
kxn	MY		
kyi	MY		
kys	MY		
kzi	MY		
kzs	MY		
lhn	MY		
lkj	MY		
llk	MY		
lnd	MY		
lnh	MY	1	1
low	MY		
lra	MY		
mal	MY		
mcm	MY		
mel	MY		
meo	MY		
mfa	MY		
mhe	MY	1	1
mnq	MY	1	1
mqq	MY		
msa	MY	1	1
msi	MY		
mvv	MY		
mxr	MY		
mzt	MY	1	1
nan	MY		
nrm	MY		
ntd	MY		
orn	MY		
ors	MY		
pez	MY		
plz	MY		
pna	MY		
pne	MY		
pnm	MY		
psg	MY		
ree	MY		
ruu	MY		
sbo	MY	1	1
sdo	MY		
sdx	MY		
sea	MY	1	1
sib	MY		
skp	MY		
sne	MY		
snv	MY		
spg	MY		
srk	MY		
ssb	MY		
ssm	MY	1	1
sza	MY	1	1
szc	MY	1	1
szd	MY		
tam	MY		
tea	MY	1	1
tgb	MY		
tgq	MY		
tih	MY		
tmo	MY	1	1
tmw	MY		
tnz	MY	1	1
trx	MY		
tsg	MY		
ttw	MY		
txa	MY		
txx	MY		
umi	MY		
xbn	MY		
xkl	MY		
xky	MY		
xml	MY		
yue	MY		
zbc	MY		
zbe	MY		
zbw	MY		
zho	MY	0	1
zlm	MY		
zmi	MY		
zsm	MY		
bwg	MZ		
cce	MZ		
chw	MZ		
cwb	MZ		
dmx	MZ		
eko	MZ		
fra	MZ	0	0
llb	MZ		
mgh	MZ		
mhm	MZ		
mny	MZ		
mzy	MZ		
ndc	MZ		
ngl	MZ		
nte	MZ		
nya	MZ		
nyu	MZ		
phm	MZ		
por	MZ	0	0
rng	MZ		
seh	MZ		
swa	MZ	1	1
tke	MZ		
toh	MZ		
tsc	MZ		
tso	MZ		
twl	MZ		
twx	MZ		
vmk	MZ		
vmr	MZ		
vmw	MZ		
wmw	MZ		
xmc	MZ		
xnq	MZ		
xsq	MZ		
yao	MZ		
ymk	MZ		
zul	MZ		
afr	NA	1	0
deu	NA		
diu	NA		
eng	NA	0	0
fwe	NA		
her	NA		
hgm	NA		
ktz	NA		
kua	NA		
kwm	NA		
kwn	NA		
lnb	NA		
naq	NA		
nbs	NA		
ndo	NA		
sbs	NA		
tsn	NA		
vaj	NA		
xuu	NA		
aek	NC	1	1
aji	NC	1	1
ane	NC	1	1
aok	NC	1	1
aqr	NC	1	1
axx	NC	1	1
bpk	NC	1	1
bwa	NC	1	1
cam	NC	1	1
cir	NC	1	1
cks	NC		
dhv	NC	1	1
duf	NC	1	1
fra	NC	0	0
fwa	NC	1	1
hvk	NC		
iai	NC		
jas	NC		
jaz	NC		
kdk	NC		
mkt	NC		
mrk	NC		
msq	NC		
nee	NC		
nek	NC		
nem	NC		
nen	NC		
nua	NC		
piz	NC		
pme	NC		
pop	NC		
pri	NC		
sih	NC		
uve	NC		
wmn	NC		
yly	NC		
ara	NE	0	1
bms	NE		
dje	NE		
fra	NE	0	0
fuh	NE		
ful	NE		
fuq	NE		
hau	NE	1	1
kau	NE		
kby	NE		
krt	NE		
tda	NE		
tez	NE	1	1
thz	NE	1	1
tmh	NE	1	1
ttq	NE	1	1
twq	NE		
eng	NF	0	0
pih	NF		
aaa	NG		
aab	NG		
abm	NG		
abn	NG		
abo	NG		
acb	NG		
acp	NG		
adu	NG		
afe	NG		
afn	NG		
afo	NG		
agb	NG		
agc	NG		
ahn	NG		
ahs	NG		
aik	NG		
ajw	NG	1	1
akd	NG	1	1
akf	NG	1	1
ala	NG		
alf	NG		
amb	NG		
amo	NG		
anc	NG	1	1
ank	NG	1	1
ann	NG		
anw	NG		
aqg	NG		
aqk	NG		
ara	NG	0	1
asg	NG		
atg	NG		
aum	NG		
auo	NG	1	1
awc	NG		
awo	NG		
aye	NG		
ayi	NG		
ayk	NG		
ayu	NG		
bau	NG		
bba	NG		
bbs	NG		
bbt	NG	1	1
bbu	NG		
bcn	NG		
bcs	NG		
bcv	NG		
bcy	NG	1	1
bde	NG	1	1
bga	NG		
bgu	NG		
bil	NG		
bin	NG		
bka	NG		
bkv	NG		
bky	NG		
bma	NG		
bol	NG	1	1
bom	NG		
bqp	NG		
bqv	NG		
bqw	NG		
bqx	NG		
brt	NG		
bsf	NG		
bsj	NG		
bsl	NG		
bsr	NG		
bsx	NG		
bta	NG	1	1
bte	NG		
btt	NG		
btu	NG		
buj	NG		
bus	NG		
bux	NG	1	1
buz	NG		
bvh	NG	1	1
bvj	NG		
bvw	NG	1	1
bwr	NG	1	1
bxo	NG		
bxq	NG	1	1
byc	NG		
byf	NG		
byj	NG		
byp	NG		
bys	NG		
bzw	NG		
bzy	NG		
bzz	NG		
cbo	NG		
cbq	NG		
ccg	NG		
cch	NG		
cdr	NG		
cen	NG		
cet	NG		
cfa	NG		
cfd	NG		
cfg	NG		
cie	NG	1	1
ckl	NG	1	1
cky	NG	1	1
cla	NG	1	1
cry	NG		
cxh	NG	1	1
dam	NG		
dbb	NG	1	1
dbd	NG		
dbi	NG		
dbm	NG		
dbo	NG		
dbp	NG	1	1
dbv	NG		
deg	NG		
dgh	NG	1	1
dio	NG		
dir	NG		
dkg	NG		
dmf	NG		
doh	NG		
dot	NG	1	1
dri	NG		
dsk	NG	1	1
dwa	NG	1	1
dyr	NG	1	1
dza	NG		
dzd	NG	1	1
ebg	NG		
efa	NG		
efi	NG		
ego	NG		
ehu	NG		
eka	NG		
eke	NG		
eki	NG		
ekp	NG		
ekr	NG		
elm	NG		
ema	NG		
eng	NG	0	0
enn	NG		
env	NG		
enw	NG		
epi	NG		
erh	NG		
etb	NG		
ets	NG		
etu	NG		
etx	NG		
evh	NG		
eza	NG		
eze	NG		
fah	NG		
fam	NG		
fie	NG	1	1
fir	NG		
fkk	NG	1	1
fli	NG	1	1
fub	NG		
ful	NG		
fum	NG		
fuv	NG	1	1
gbr	NG		
gby	NG		
gde	NG	1	1
gdf	NG	1	1
gdu	NG	1	1
gea	NG	1	1
ged	NG		
geg	NG		
gek	NG	1	1
gel	NG		
gew	NG	1	1
gib	NG		
gkn	NG		
glb	NG	1	1
glo	NG	1	1
glw	NG	1	1
gmd	NG		
gmz	NG		
gne	NG		
gnh	NG		
gpa	NG		
gqa	NG	1	1
grd	NG	1	1
grh	NG		
gua	NG		
guw	NG		
gvm	NG		
gwb	NG		
gwg	NG		
gwn	NG	1	1
gye	NG		
gyz	NG	1	1
hau	NG	1	1
hbb	NG	1	1
hia	NG	1	1
hig	NG	1	1
hod	NG	1	1
hoe	NG		
hsl	NG		
hwo	NG	1	1
ibb	NG		
ibe	NG		
ibm	NG		
ibn	NG		
ibo	NG	1	1
ibr	NG		
iby	NG		
ich	NG		
idc	NG		
ide	NG		
ids	NG		
idu	NG		
igb	NG		
ige	NG		
igl	NG		
igw	NG		
ihi	NG		
ijc	NG		
ije	NG		
ijn	NG		
ijs	NG		
ikh	NG		
iki	NG		
ikk	NG		
ikl	NG		
iko	NG		
ikp	NG		
ikv	NG		
ikw	NG		
ilv	NG		
iqw	NG		
iri	NG		
ish	NG		
isi	NG		
iso	NG		
itm	NG		
its	NG		
itw	NG		
iya	NG		
izm	NG		
izr	NG		
izz	NG		
jab	NG		
jaf	NG	1	1
jbm	NG		
jen	NG		
jer	NG		
jgk	NG		
jib	NG		
jid	NG		
jie	NG	1	1
jjr	NG		
jku	NG		
jmb	NG	1	1
jmi	NG	1	1
jms	NG		
jni	NG		
jrr	NG		
jrt	NG	1	1
jub	NG		
juh	NG		
juk	NG		
juo	NG		
juu	NG	1	1
juw	NG		
kad	NG		
kai	NG	1	1
kaj	NG		
kau	NG		
kby	NG		
kbz	NG	1	1
kcc	NG		
kce	NG		
kcf	NG		
kcg	NG		
kch	NG		
kci	NG		
kcq	NG		
kcs	NG	1	1
kdl	NG		
kdm	NG		
kdp	NG		
kdx	NG		
kes	NG		
kez	NG		
kgt	NG		
khj	NG		
kil	NG	1	1
kka	NG		
kkd	NG		
kkm	NG		
kkr	NG	1	1
kks	NG	1	1
kku	NG		
klk	NG		
klo	NG		
kmi	NG		
kmy	NG		
kna	NG	1	1
knc	NG		
kni	NG		
koc	NG		
kof	NG	1	1
kov	NG		
kow	NG		
kpa	NG	1	1
kpk	NG		
krh	NG		
krp	NG		
ksa	NG		
ksm	NG		
kso	NG		
ksp	NG		
ksq	NG	1	1
ktc	NG	1	1
kub	NG		
kug	NG		
kuh	NG	1	1
kul	NG	1	1
kwb	NG		
kwl	NG	1	1
lan	NG		
ldb	NG		
ldd	NG	1	1
ldg	NG		
ldh	NG		
ldj	NG		
ldk	NG		
ldl	NG		
ldo	NG		
ldp	NG		
ldq	NG		
lla	NG		
lnu	NG		
lop	NG		
mae	NG		
mbu	NG		
mcj	NG		
mda	NG		
mew	NG	1	1
mfl	NG	1	1
mfm	NG	1	1
mfn	NG		
mfo	NG		
mgi	NG		
mgj	NG		
mjs	NG	1	1
mkf	NG	1	1
mko	NG		
mma	NG		
mmf	NG	1	1
moi	NG		
mrt	NG	1	1
mtl	NG	1	1
mzk	NG		
mzm	NG		
nar	NG		
nat	NG		
nbb	NG		
nbh	NG	1	1
nbo	NG		
nbp	NG		
nbr	NG		
ndd	NG		
ndi	NG		
ndr	NG		
ned	NG		
nfd	NG		
ngi	NG	1	1
ngs	NG	1	1
ngw	NG	1	1
ngx	NG	1	1
nin	NG		
nja	NG	1	1
njr	NG		
nkx	NG		
nkz	NG		
nmi	NG	1	1
nqt	NG	1	1
nsc	NG		
nsi	NG		
nuh	NG		
nup	NG		
nzr	NG	1	1
obu	NG		
oda	NG		
odu	NG		
ofu	NG		
ogb	NG		
ogc	NG		
ogg	NG		
ogo	NG		
ogu	NG		
okb	NG		
okd	NG		
oke	NG		
okr	NG		
oks	NG		
okx	NG		
olm	NG		
opa	NG		
org	NG		
orr	NG		
orx	NG		
oso	NG		
pai	NG		
pbl	NG		
pbn	NG		
pcm	NG	1	1
pcn	NG		
pcw	NG	1	1
pgs	NG		
pip	NG	1	1
piy	NG	1	1
png	NG		
pqa	NG	1	1
pwb	NG		
pym	NG		
pze	NG	1	1
rax	NG		
res	NG		
rin	NG		
rod	NG		
rsw	NG		
ruk	NG		
ruy	NG		
ruz	NG		
say	NG	1	1
scv	NG		
scw	NG	1	1
sde	NG		
sha	NG		
sho	NG		
shu	NG	1	1
sir	NG	1	1
sqa	NG		
sqh	NG		
sur	NG	1	1
sxs	NG		
syk	NG	1	1
tak	NG	1	1
tal	NG	1	1
tan	NG	1	1
tdk	NG	1	1
tdl	NG		
tdo	NG		
tdq	NG		
tdv	NG		
tgd	NG	1	1
thy	NG		
tiv	NG		
tkq	NG		
tsw	NG		
ttb	NG		
ttr	NG	1	1
tul	NG		
tvd	NG		
tvi	NG	1	1
twc	NG	1	1
txj	NG		
tye	NG		
tyy	NG		
uba	NG		
uda	NG		
uha	NG		
uji	NG		
ukp	NG		
ukq	NG		
uku	NG		
ukw	NG		
ula	NG		
ulb	NG		
uly	NG	1	1
umm	NG		
une	NG		
urh	NG		
uss	NG		
uta	NG		
uth	NG		
utr	NG		
uya	NG		
vem	NG	1	1
ver	NG		
vit	NG		
vki	NG		
vkn	NG		
vkz	NG		
vor	NG		
wav	NG		
wja	NG		
wji	NG	1	1
wma	NG		
wom	NG		
xab	NG		
xoc	NG		
xsh	NG		
xsn	NG		
yay	NG		
yaz	NG		
yba	NG		
ybj	NG		
ybl	NG		
yer	NG		
yes	NG		
ynq	NG		
yor	NG	1	1
yot	NG		
yun	NG		
zah	NG	1	1
zaz	NG	1	1
zbu	NG	1	1
zem	NG	1	1
zhi	NG		
ziz	NG	1	1
zlu	NG	1	1
zns	NG	1	1
bzk	NI		
miq	NI		
mom	NI		
mtn	NI		
ncs	NI		
rma	NI		
spa	NI	0	0
sut	NI		
ulw	NI		
yan	NI		
act	NL		
deu	NL	1	1
drt	NL		
dse	NL		
dum	NL		
eng	NL	0	1
fra	NL	0	0
fry	NL		
gos	NL		
ido	NL	0	1
ind	NL		
lim	NL		
msa	NL		
nds	NL		
nld	NL	1	1
odt	NL		
ofs	NL		
rif	NL	0	0
sdz	NL		
stl	NL		
tur	NL	0	0
twd	NL		
vel	NL		
vls	NL		
zea	NL		
fkv	NO		
fra	NO		
nno	NO		
nob	NO		
nor	NO		
nsl	NO		
rmg	NO		
rom	NO	0	0
sme	NO		
anp	NP		
aph	NP		
awa	NP		
bap	NP		
bee	NP		
ben	NP		
bfy	NP		
bgc	NP		
bhj	NP		
bho	NP		
bmj	NP		
bod	NP		
brd	NP		
brx	NP		
byh	NP		
byw	NP		
cdm	NP		
chx	NP		
ctn	NP		
cur	NP		
cuw	NP		
dhi	NP		
dhw	NP		
dre	NP		
drq	NP		
dry	NP		
dty	NP		
dus	NP		
dwz	NP		
emg	NP		
eng	NP	0	0
gds	NP		
ghe	NP		
ghh	NP		
ght	NP		
gvr	NP		
gyo	NP		
hin	NP		
hut	NP		
jee	NP		
jhs	NP		
jml	NP		
jul	NP		
jus	NP		
kdq	NP		
kgg	NP		
kgj	NP		
kgy	NP		
khr	NP	1	1
kif	NP		
kip	NP		
kjl	NP		
kkt	NP		
kle	NP		
klr	NP		
kra	NP		
kru	NP		
kte	NP		
kyv	NP		
kyw	NP		
kzq	NP		
lah	NP		
lbr	NP		
lep	NP		
lhm	NP		
lif	NP		
lmh	NP		
loy	NP		
lrr	NP		
luu	NP		
mag	NP		
mai	NP		
mgp	NP		
mjz	NP		
mrd	NP		
muk	NP		
mwr	NP		
nao	NP		
ncd	NP		
nep	NP	1	1
new	NP		
nmm	NP		
npa	NP		
npi	NP	1	1
nsp	NP		
nwc	NP		
nwx	NP		
ola	NP		
pan	NP		
phj	NP		
phw	NP		
pum	NP		
raa	NP		
rab	NP		
raf	NP		
raq	NP		
rau	NP		
rav	NP		
rji	NP		
rjs	NP		
san	NP		
sat	NP	0	0
sck	NP		
scp	NP		
skj	NP		
smm	NP		
snd	NP		
soi	NP		
suz	NP		
syw	NP		
taj	NP		
tcn	NP		
tdg	NP		
tdh	NP		
tge	NP		
the	NP		
thf	NP		
thl	NP		
thq	NP		
thr	NP		
ths	NP		
tij	NP		
tkb	NP		
tkt	NP		
tsf	NP		
ttz	NP		
unr	NP	0	0
unx	NP		
urd	NP		
vay	NP		
vjk	NP		
wly	NP		
wme	NP		
xis	NP		
xsr	NP		
ybh	NP		
ybi	NP		
cpi	NR		
eng	NR	0	0
nau	NR		
eng	NU	0	0
niu	NU		
eng	NZ	0	0
mri	NZ		
nzs	NZ		
rrm	NZ		
acx	OM	1	1
adf	OM	1	1
ara	OM	1	1
bal	OM		
bhm	OM	1	1
fas	OM	0	1
hoh	OM	1	1
hss	OM	1	1
luv	OM		
shv	OM	1	1
zum	OM		
cto	PA		
cuk	PA		
emp	PA		
eng	PA	0	0
gym	PA		
hak	PA		
jam	PA		
kvn	PA		
lsp	PA		
noa	PA		
sab	PA		
scf	PA		
sja	PA		
spa	PA	0	0
tfr	PA		
ydd	PA		
yid	PA		
zho	PA	0	0
acu	PE		
aga	PE		
agr	PE		
amc	PE		
ame	PE		
amr	PE		
anb	PE		
arl	PE	1	1
ash	PE	1	1
atc	PE		
avs	PE		
ayc	PE		
aym	PE		
ayr	PE		
boa	PE		
cah	PE		
cbr	PE		
cbs	PE		
cbt	PE		
cbu	PE		
ccc	PE		
cht	PE		
cjo	PE		
cni	PE		
cod	PE		
cot	PE		
cox	PE		
cpb	PE		
cpc	PE		
cpu	PE		
cpy	PE		
cuj	PE		
fra	PE		
hib	PE		
hub	PE		
hug	PE		
huu	PE		
hux	PE		
inp	PE		
iqu	PE		
isc	PE		
jeb	PE		
jqr	PE		
kaq	PE		
lsv	PE		
mcb	PE		
mcd	PE		
mcf	PE		
mts	PE		
myr	PE		
not	PE		
oca	PE		
omc	PE		
omg	PE		
omu	PE		
ore	PE		
pib	PE		
pig	PE		
pno	PE		
prl	PE		
prq	PE		
qub	PE		
que	PE		
quf	PE		
quk	PE		
qup	PE		
qur	PE		
qux	PE		
quy	PE		
quz	PE		
qva	PE		
qvc	PE		
qve	PE		
qvh	PE		
qvl	PE		
qvm	PE		
qvn	PE		
qvo	PE		
qvp	PE		
qvs	PE		
qvw	PE		
qwa	PE		
qwc	PE		
qwh	PE		
qws	PE		
qxa	PE		
qxc	PE		
qxh	PE		
qxn	PE		
qxo	PE		
qxp	PE		
qxt	PE		
qxu	PE		
qxw	PE		
rem	PE		
rgr	PE		
shp	PE		
sni	PE		
spa	PE	0	0
spq	PE	1	1
trr	PE		
ura	PE		
yaa	PE		
yad	PE		
yme	PE		
aut	PF	1	1
fra	PF		
mqm	PF		
mrq	PF		
mrv	PF		
pmt	PF		
ray	PF		
tah	PF		
zho	PF	0	0
aac	PG		
aad	PG		
aag	PG	1	1
aah	PG	1	1
aai	PG	1	1
aak	PG	1	1
aau	PG		
aaw	PG	1	1
abg	PG		
abt	PG		
abw	PG		
aby	PG		
ado	PG		
adz	PG	1	1
aew	PG		
aey	PG		
aez	PG		
afd	PG	1	1
afi	PG		
afk	PG	1	1
afp	PG	1	1
agd	PG		
age	PG		
agg	PG		
agl	PG		
agm	PG	1	1
ago	PG	1	1
aic	PG		
aie	PG	1	1
aif	PG		
ail	PG		
aix	PG	1	1
akh	PG	1	1
aki	PG	1	1
akq	PG		
akt	PG	1	1
ali	PG		
alx	PG		
amm	PG		
amn	PG		
amp	PG		
amt	PG	1	1
anh	PG		
anj	PG		
anx	PG	1	1
anz	PG		
aob	PG	1	1
aod	PG		
aoe	PG		
aof	PG		
aog	PG		
aoj	PG		
aom	PG		
aon	PG		
ape	PG		
apo	PG	1	1
apr	PG	1	1
aps	PG	1	1
apz	PG	1	1
aso	PG		
asx	PG		
ata	PG		
ate	PG		
aui	PG	1	1
auk	PG		
aun	PG		
aup	PG	1	1
aur	PG		
auy	PG		
avb	PG	1	1
avt	PG		
awb	PG		
awi	PG		
awm	PG		
aww	PG		
awx	PG		
aya	PG		
ayq	PG		
bbb	PG		
bbd	PG		
bbf	PG		
bbn	PG	1	1
bbr	PG		
bbv	PG	1	1
bcf	PG		
bch	PG	1	1
bcm	PG	1	1
bco	PG		
bcu	PG	1	1
bdd	PG	1	1
bdf	PG		
bef	PG		
bek	PG	1	1
beo	PG		
bey	PG		
bfh	PG		
bhf	PG		
bhg	PG		
bhl	PG		
bic	PG		
bie	PG		
big	PG		
bio	PG		
biq	PG	1	1
bir	PG		
bit	PG		
bjc	PG		
bjh	PG		
bjk	PG	1	1
bjl	PG	1	1
bjp	PG	1	1
bjr	PG		
bjz	PG		
blb	PG		
blq	PG	1	1
bmc	PG	1	1
bmh	PG		
bmk	PG	1	1
bmn	PG	1	1
bmp	PG		
bmu	PG		
bmx	PG		
bmz	PG	1	1
bnp	PG	1	1
bnw	PG		
boj	PG		
bon	PG		
bop	PG		
boq	PG		
bow	PG		
bpe	PG		
bpi	PG		
bpm	PG		
bpu	PG		
bpw	PG		
bql	PG		
bqs	PG		
brq	PG		
bry	PG		
brz	PG	1	1
btp	PG	1	1
buk	PG	1	1
buo	PG		
buq	PG		
but	PG		
buv	PG		
bvn	PG		
bwd	PG	1	1
bwf	PG	1	1
bwk	PG		
bwm	PG		
bxf	PG	1	1
bxh	PG	1	1
bxz	PG		
bye	PG		
byr	PG	1	1
byx	PG		
byz	PG		
bzf	PG		
bzh	PG	1	1
can	PG		
cga	PG		
cjn	PG		
cjv	PG		
ckr	PG		
dac	PG	1	1
dad	PG	1	1
dah	PG		
dby	PG		
ddi	PG	1	1
ded	PG		
dev	PG		
dge	PG		
dgg	PG	1	1
dgx	PG		
dgz	PG		
dia	PG		
dju	PG		
dmc	PG		
dnd	PG		
dnr	PG		
doa	PG		
dob	PG	1	1
dof	PG		
dol	PG		
don	PG	1	1
duc	PG		
dui	PG		
duk	PG		
dva	PG	1	1
dww	PG	1	1
eit	PG		
eiv	PG		
ele	PG		
elk	PG		
elu	PG	1	1
emi	PG	1	1
ena	PG		
eng	PG	0	0
enq	PG		
eri	PG		
etr	PG		
faa	PG		
fad	PG		
fag	PG		
fai	PG		
faj	PG		
ffi	PG		
fiw	PG		
foi	PG		
for	PG		
fqs	PG		
frq	PG		
fuy	PG		
gaf	PG		
gah	PG		
gai	PG		
gaj	PG		
gam	PG		
gao	PG		
gap	PG		
gar	PG	1	1
gat	PG		
gaw	PG		
gbe	PG		
gbf	PG		
gcc	PG		
gcn	PG		
gdd	PG	1	1
gdn	PG		
gdr	PG		
geb	PG		
gfk	PG	1	1
ggl	PG		
ggt	PG	1	1
ggw	PG		
ghs	PG		
gim	PG		
gip	PG	1	1
gka	PG		
gkd	PG		
gmg	PG		
gmu	PG		
gnm	PG		
gnt	PG		
gnu	PG		
goc	PG	1	1
goi	PG		
gpn	PG		
grg	PG		
grq	PG		
grw	PG	1	1
grx	PG		
grz	PG	1	1
gsn	PG		
gsp	PG		
gve	PG	1	1
gvf	PG		
gvs	PG	1	1
gyb	PG		
hah	PG	1	1
ham	PG		
hao	PG	1	1
hgw	PG	1	1
hhi	PG	1	1
hhy	PG	1	1
hih	PG		
hkk	PG		
hla	PG		
hmo	PG		
hmt	PG	1	1
hob	PG		
hot	PG		
hrc	PG		
hrw	PG		
huf	PG		
hui	PG		
hul	PG		
ian	PG		
iar	PG		
idi	PG		
igg	PG		
igm	PG		
igo	PG		
imi	PG		
imn	PG		
imo	PG		
ino	PG		
iou	PG		
ipi	PG		
ipo	PG	1	1
isa	PG		
itr	PG		
iwm	PG		
iws	PG		
jae	PG		
jbk	PG		
jet	PG		
jil	PG		
jko	PG		
jma	PG		
jmw	PG		
kbk	PG		
kbm	PG		
kbq	PG		
kbt	PG		
kbw	PG		
kbx	PG		
kcb	PG	1	1
kcl	PG		
kco	PG		
kct	PG		
kdf	PG		
keh	PG		
kew	PG		
kgf	PG		
kgu	PG		
khl	PG		
khs	PG		
khz	PG		
kih	PG		
kij	PG		
kis	PG		
kit	PG		
kiw	PG		
kjd	PG		
kjs	PG		
kjx	PG		
kjy	PG		
kkc	PG		
klh	PG		
klm	PG		
klp	PG	1	1
klq	PG		
klt	PG		
klx	PG		
kmf	PG		
kmg	PG		
kmh	PG		
kmn	PG		
kmo	PG		
kms	PG		
kmu	PG		
kmx	PG		
knr	PG		
knv	PG		
koa	PG		
kol	PG		
kop	PG		
koz	PG		
kpf	PG		
kpr	PG		
kpw	PG		
kpx	PG		
kqa	PG		
kqb	PG		
kqc	PG		
kqf	PG		
kqi	PG		
kqj	PG		
kql	PG		
kqw	PG		
ksd	PG		
kse	PG		
ksi	PG		
ksj	PG		
ksl	PG		
ksr	PG		
ktk	PG		
ktm	PG		
kto	PG		
kud	PG		
kue	PG		
kuo	PG		
kup	PG		
kvc	PG		
kvg	PG	1	1
kwj	PG		
kwo	PG		
kxa	PG		
kxr	PG		
kxt	PG		
kxw	PG		
kxz	PG		
kyc	PG		
kyg	PG		
kyx	PG		
kyy	PG		
kze	PG		
laz	PG		
lbb	PG		
lbq	PG		
lbu	PG		
lbv	PG		
lcm	PG		
lei	PG		
lek	PG		
leq	PG		
ler	PG		
let	PG		
leu	PG		
lgt	PG		
lib	PG		
lid	PG		
lih	PG		
lkl	PG		
lle	PG		
llf	PG		
lll	PG		
lmg	PG		
lni	PG		
lnm	PG		
loj	PG		
los	PG		
lsr	PG		
luf	PG		
lxm	PG		
mbh	PG		
mbk	PG		
mbq	PG		
mbw	PG		
mbx	PG		
mcc	PG	1	1
mci	PG		
mcq	PG		
mcr	PG	1	1
mcv	PG	1	1
mcy	PG		
mcz	PG		
mdb	PG		
mdc	PG		
mds	PG		
meb	PG		
med	PG		
mee	PG		
mek	PG		
met	PG		
meu	PG		
mft	PG		
mfw	PG		
mgl	PG		
mgt	PG		
mgu	PG		
mhf	PG		
mhl	PG		
miw	PG	1	1
mjj	PG		
mjk	PG		
mjm	PG		
mjn	PG		
mkc	PG		
mkp	PG		
mkr	PG		
mle	PG		
mlh	PG		
mlp	PG		
mmi	PG		
mmo	PG		
mmp	PG	1	1
mmq	PG		
mmt	PG		
mmx	PG		
mna	PG		
mnm	PG		
mox	PG		
mpl	PG		
mpn	PG		
mpo	PG		
mpp	PG		
mps	PG		
mpt	PG		
mpv	PG		
mpx	PG		
mqe	PG		
mqv	PG		
mqw	PG		
mqz	PG		
msu	PG		
msx	PG		
msy	PG		
msz	PG		
mtc	PG		
mtf	PG		
mti	PG		
mtv	PG		
mty	PG		
mum	PG		
mux	PG		
mva	PG		
mvk	PG		
mvn	PG		
mvq	PG		
mwa	PG		
mwb	PG		
mwc	PG		
mwg	PG		
mwh	PG		
mxk	PG		
mxm	PG		
mxw	PG		
myd	PG		
myw	PG		
mze	PG		
mzu	PG		
mzz	PG		
nac	PG		
naf	PG		
nak	PG		
nal	PG		
nas	PG		
nax	PG		
nbk	PG		
nby	PG		
nca	PG		
ncc	PG		
nce	PG		
ncf	PG		
ncm	PG		
ncn	PG		
nco	PG		
nej	PG		
net	PG		
nex	PG		
nho	PG		
nib	PG		
nif	PG		
nii	PG		
nis	PG		
niw	PG		
niz	PG		
nkg	PG		
nkm	PG		
nmw	PG		
nmx	PG		
nnf	PG		
nnk	PG		
nnm	PG		
noc	PG		
nof	PG		
noh	PG		
nop	PG		
nou	PG		
npn	PG		
nqn	PG		
nrz	PG		
nsn	PG		
nss	PG		
nud	PG		
nuq	PG		
nur	PG		
nux	PG		
nvm	PG		
nwr	PG		
nxr	PG		
oin	PG		
okk	PG		
okv	PG		
omo	PG		
omw	PG		
ong	PG		
onj	PG		
onk	PG		
onn	PG		
onr	PG		
ons	PG		
ont	PG		
opm	PG		
opo	PG		
oro	PG		
osu	PG		
oue	PG		
oum	PG		
owi	PG		
oyy	PG		
pby	PG		
pda	PG		
ped	PG		
pek	PG		
pep	PG		
pex	PG		
pgi	PG		
pgz	PG		
pin	PG		
pix	PG		
pkg	PG		
pla	PG		
pmr	PG		
pnn	PG		
pnr	PG		
ppe	PG		
ppn	PG		
ppo	PG		
ppq	PG		
ppt	PG		
prm	PG		
prw	PG		
psq	PG		
pss	PG		
ptp	PG		
pup	PG		
pux	PG		
pwa	PG		
pwg	PG		
rai	PG		
rak	PG		
rao	PG		
rea	PG		
rhp	PG		
rmk	PG		
rmp	PG		
roe	PG		
roo	PG	1	1
rpt	PG		
rro	PG		
rwa	PG		
rwo	PG		
sbc	PG		
sbe	PG		
sbh	PG		
sbi	PG		
sbq	PG		
sdk	PG		
sej	PG		
seo	PG		
sew	PG		
sgz	PG		
sij	PG		
sim	PG		
siq	PG		
siu	PG		
siv	PG		
siw	PG		
six	PG		
sjr	PG		
skc	PG		
skm	PG		
sks	PG		
sll	PG		
slw	PG		
smb	PG	1	1
smc	PG		
smf	PG		
smg	PG		
smq	PG		
smz	PG		
snc	PG		
snp	PG		
snr	PG		
snx	PG		
sny	PG		
snz	PG		
sol	PG		
soq	PG		
sow	PG		
spd	PG		
spe	PG		
spk	PG		
spl	PG		
spm	PG		
sps	PG		
sra	PG		
srf	PG		
sry	PG		
ssd	PG		
ssg	PG		
ssj	PG		
sso	PG		
sst	PG		
ssu	PG	1	1
ssx	PG		
ssz	PG		
stf	PG		
stk	PG		
stm	PG		
sua	PG		
sue	PG		
sug	PG		
sui	PG		
suo	PG		
svb	PG		
swm	PG		
swp	PG		
szb	PG		
taw	PG		
tbc	PG		
tbd	PG		
tbf	PG		
tbg	PG		
tbj	PG		
tbo	PG		
tbs	PG		
tbv	PG		
tbx	PG		
tci	PG		
tei	PG		
tgc	PG		
tgi	PG		
tgo	PG		
tgu	PG		
tif	PG		
tim	PG		
tio	PG		
tkv	PG		
tlf	PG		
tlx	PG		
tmd	PG		
tmq	PG		
tmy	PG		
tnh	PG		
tns	PG		
tof	PG		
tpa	PG		
tpi	PG		
tpz	PG		
tqm	PG		
tqo	PG		
tqp	PG		
tqu	PG		
trb	PG		
trh	PG		
tsx	PG	1	1
ttd	PG		
tte	PG		
ttu	PG		
ttv	PG		
tua	PG		
tuc	PG		
tuh	PG		
twp	PG		
tww	PG		
tya	PG		
tzx	PG		
uar	PG		
ubr	PG		
ubu	PG		
ufi	PG		
uis	PG		
ukg	PG		
uln	PG		
una	PG		
uni	PG		
unu	PG		
upi	PG		
urg	PG		
uri	PG		
urm	PG		
uro	PG		
urt	PG		
urv	PG		
urw	PG		
urx	PG		
usa	PG		
usu	PG		
utu	PG		
uvh	PG		
uvl	PG		
val	PG		
vam	PG		
van	PG		
viv	PG		
vmg	PG		
wab	PG		
wag	PG		
waj	PG		
wat	PG		
wax	PG		
waz	PG		
wdg	PG		
wed	PG		
wei	PG	1	1
wer	PG		
wgb	PG		
wgi	PG		
whg	PG		
wii	PG		
wiu	PG		
wiv	PG		
wla	PG		
wmc	PG		
wmo	PG		
wmx	PG		
wnb	PG		
wnc	PG		
wnp	PG		
wnu	PG		
woc	PG		
wog	PG		
wos	PG		
wrs	PG		
wrv	PG		
wsk	PG		
wsr	PG		
wtf	PG		
wtk	PG		
wut	PG		
wuv	PG		
xar	PG		
xbi	PG		
xes	PG		
xeu	PG		
xkx	PG		
xla	PG		
xoi	PG		
xop	PG		
xow	PG		
xrw	PG		
xsi	PG		
xsp	PG		
ybm	PG		
ybo	PG		
ybx	PG		
yby	PG		
yde	PG		
ydk	PG		
yee	PG		
yev	PG		
ygl	PG		
ygm	PG		
ygr	PG		
ygw	PG	1	1
yis	PG		
ykk	PG		
ykm	PG		
ykr	PG		
yla	PG		
ylb	PG		
yle	PG		
ylg	PG		
yll	PG		
ylu	PG		
ymb	PG		
yml	PG		
ymo	PG		
ymp	PG		
ynl	PG		
yob	PG		
yon	PG		
yra	PG		
yrb	PG		
yrw	PG		
yss	PG		
ytw	PG		
yuj	PG		
yut	PG		
yuw	PG		
ywa	PG		
yyu	PG		
zeg	PG		
zgr	PG		
zia	PG		
zik	PG	1	1
zmh	PG		
zsa	PG		
zsu	PG		
zuh	PG		
abc	PH	1	1
abd	PH	1	1
abp	PH	1	1
abx	PH	1	1
agk	PH	1	1
agn	PH	1	1
agt	PH	1	1
agv	PH	1	1
agy	PH	1	1
agz	PH	1	1
akl	PH	1	1
alj	PH	1	1
apf	PH	1	1
aqn	PH	1	1
atd	PH	1	1
atk	PH	1	1
atl	PH	1	1
atm	PH	1	1
atp	PH	1	1
att	PH	1	1
atz	PH	1	1
ays	PH		
ayt	PH	1	1
ayy	PH		
azt	PH	1	1
bcl	PH	1	1
bfx	PH	1	1
bgi	PH	1	1
bgs	PH	1	1
bik	PH	1	1
bjx	PH	1	1
bkd	PH	1	1
bks	PH	1	1
bku	PH	1	1
bln	PH	1	1
blw	PH	1	1
blx	PH	1	1
bnc	PH	1	1
bnj	PH	1	1
bno	PH	1	1
bpr	PH	1	1
bps	PH	1	1
btn	PH	1	1
bto	PH	1	1
btw	PH	1	1
bvy	PH	1	1
bya	PH	1	1
cbk	PH		
cbw	PH	1	1
ceb	PH	1	1
cgc	PH	1	1
clu	PH	1	1
cps	PH	1	1
cts	PH	1	1
cyo	PH	1	1
daw	PH	1	1
dgc	PH	1	1
due	PH	1	1
dul	PH	1	1
duo	PH	1	1
duy	PH	1	1
dyg	PH		
ebk	PH	1	1
eng	PH	0	0
esy	PH	1	1
fbl	PH	1	1
fil	PH	1	1
gad	PH	1	1
gdg	PH	1	1
hil	PH	1	1
hnn	PH		
ibg	PH		
ibl	PH		
ifa	PH		
ifb	PH		
ifk	PH		
ifu	PH		
ify	PH		
ilk	PH		
ilo	PH	1	1
ilp	PH		
inn	PH		
iry	PH		
isd	PH		
itb	PH		
iti	PH		
itt	PH		
itv	PH		
ity	PH		
ivb	PH		
ivv	PH		
iwk	PH		
kak	PH		
kkg	PH		
klg	PH		
kll	PH		
kmd	PH		
kmk	PH		
kml	PH		
knb	PH		
kne	PH		
kor	PH		
kqe	PH		
krj	PH		
ksc	PH		
ksn	PH		
ktq	PH		
kyb	PH		
kyj	PH		
kyk	PH		
kyn	PH		
laa	PH		
lbk	PH		
lbl	PH		
loc	PH		
mba	PH		
mbb	PH		
mbd	PH		
mbi	PH		
mbs	PH		
mbt	PH		
mdh	PH		
mkx	PH		
mlz	PH		
mmn	PH		
mqk	PH		
mrw	PH		
mry	PH		
msb	PH		
msk	PH		
msm	PH		
mta	PH		
mtw	PH		
nan	PH		
obk	PH		
obo	PH		
onn	PH		
pag	PH		
pam	PH		
plc	PH		
plv	PH		
plw	PH		
prf	PH		
prh	PH		
psp	PH		
pwm	PH		
rbk	PH		
rbl	PH		
rol	PH		
sbl	PH		
sfe	PH		
sgb	PH		
sgd	PH		
sjm	PH		
skn	PH		
slm	PH		
smk	PH		
sml	PH		
snl	PH		
spa	PH	0	0
srg	PH		
srv	PH		
ssb	PH		
sse	PH		
stb	PH		
suc	PH		
sxn	PH		
syb	PH		
tbk	PH		
tbl	PH		
tbw	PH		
tdy	PH		
tgl	PH	1	1
tgn	PH		
tgt	PH		
tis	PH		
tiu	PH		
tiy	PH		
tsg	PH		
twb	PH		
ubl	PH		
vbk	PH		
war	PH		
xnn	PH		
xsb	PH		
yka	PH		
yog	PH		
zho	PH	0	0
aeq	PK		
bal	PK		
bcc	PK		
bdz	PK		
ben	PK		
bft	PK		
bgn	PK		
bgp	PK		
bgq	PK		
bhd	PK		
bhe	PK		
brh	PK		
bsh	PK		
bsk	PK		
btv	PK		
clh	PK		
deh	PK		
dmk	PK		
dml	PK		
doi	PK		
eng	PK	0	0
fas	PK	0	1
ggg	PK		
ghr	PK		
gig	PK		
gjk	PK		
gju	PK		
guj	PK		
gwc	PK		
gwf	PK		
gwt	PK		
haz	PK		
hnd	PK		
hno	PK		
jda	PK		
jdg	PK		
jnd	PK		
jog	PK		
kas	PK		
kbu	PK		
kfr	PK		
khw	PK		
kls	PK		
kvx	PK		
kxp	PK		
lah	PK	1	1
lrk	PK		
lss	PK		
mby	PK		
mki	PK		
mve	PK		
mvy	PK		
mwr	PK		
nlm	PK		
odk	PK		
oru	PK		
pan	PK	1	1
pbt	PK		
pbu	PK		
pgd	PK		
phl	PK		
phr	PK		
pks	PK		
plk	PK		
pnb	PK		
prs	PK		
prx	PK		
pst	PK		
pus	PK	1	1
raj	PK		
san	PK		
sbn	PK		
scl	PK		
sdg	PK		
shd	PK		
skr	PK	1	1
snd	PK	1	1
spt	PK		
ssi	PK		
tgk	PK		
trw	PK		
urd	PK	1	1
ush	PK		
vgr	PK		
vsn	PK		
wbl	PK		
wne	PK		
wtm	PK		
xhe	PK		
xiv	PK		
xka	PK		
xvi	PK		
ydg	PK		
zau	PK		
aar	PL	0	0
abk	PL	0	0
ach	PL	0	0
ady	PL		
ara	PL	0	0
bel	PL		
bul	PL		
cat	PL		
ces	PL		
che	PL	0	0
csb	PL		
dan	PL		
deu	PL		
ell	PL		
eng	PL	0	0
fin	PL	0	0
fra	PL		
gle	PL		
hbs	PL		
heb	PL	0	1
hin	PL		
hrv	PL		
hun	PL	0	0
hye	PL		
isl	PL		
ita	PL		
jpn	PL	0	0
kat	PL		
kor	PL	0	0
lit	PL		
mkd	PL		
mon	PL	0	0
nds	PL		
nld	PL		
nor	PL		
pol	PL	1	1
por	PL		
prg	PL		
pso	PL	1	0
rml	PL		
rom	PL	0	1
ron	PL	0	0
rue	PL		
rus	PL	0	0
sco	PL		
sli	PL		
slk	PL		
spa	PL	0	0
sqi	PL		
srp	PL		
swa	PL	0	0
swe	PL		
szl	PL		
tur	PL	0	0
ukr	PL		
vie	PL	0	0
vls	PL		
wym	PL		
xgl	PL		
xsv	PL		
yid	PL	1	1
zho	PL	0	0
eng	PM	0	0
fra	PM	0	0
eng	PN	0	0
eng	PR	0	0
fra	PR	0	0
psl	PR	1	0
spa	PR	0	0
tnq	PR	1	1
apc	PS	1	1
ara	PS	0	1
jpa	PS	1	1
sam	PS	1	1
drc	PT		
eng	PT	0	0
fra	PT		
glg	PT		
mwl	PT		
por	PT	1	1
psr	PT		
spa	PT	0	0
txr	PT		
cal	PW	1	1
eng	PW	0	0
fil	PW	0	0
jpn	PW		
pau	PW		
sov	PW		
tox	PW		
zho	PW	0	0
aqt	PY		
ayo	PY		
cag	PY		
ceg	PY		
deu	PY		
enl	PY		
enx	PY		
fra	PY		
grn	PY		
gug	PY		
guq	PY		
gva	PY		
mca	PY		
nhd	PY		
pta	PY		
pys	PY		
spa	PY	0	0
spn	PY		
tmf	PY		
tpj	PY		
afb	QA	1	1
ara	QA	1	1
fas	QA	0	1
fra	QA		
mal	QA		
fra	RE		
rcf	RE		
tam	RE		
bul	RO		
ces	RO		
deu	RO		
ell	RO		
eng	RO	0	0
fra	RO		
hbs	RO		
hrv	RO		
hun	RO		
hye	RO		
ita	RO		
mkd	RO		
pol	RO		
rms	RO		
rmy	RO		
rom	RO	0	1
ron	RO	1	1
rue	RO		
rup	RO		
rus	RO	0	0
slk	RO		
spa	RO	0	0
sqi	RO		
srp	RO		
tat	RO	0	1
tur	RO	0	1
ukr	RO		
xdc	RO		
yid	RO		
bos	RS		
cnr	RS		
fra	RS		
hbs	RS		
hrv	RS		
hun	RS		
rmn	RS		
rom	RS	0	1
ron	RS	0	1
rsb	RS		
rsk	RS		
rue	RS		
rup	RS		
slk	RS		
sqi	RS		
srp	RS		
ukr	RS		
abk	RU	1	1
abq	RU		
ady	RU		
afr	RU	0	0
agx	RU		
aii	RU	0	0
ain	RU	1	1
aka	RU	0	0
akv	RU		
ale	RU		
alr	RU		
alt	RU	1	1
amh	RU	0	0
ani	RU		
anp	RU		
aqc	RU		
ara	RU	0	1
asm	RU		
atv	RU	1	1
ava	RU		
ave	RU		
aym	RU		
aze	RU	1	1
azj	RU	1	1
bak	RU	1	1
bal	RU		
bam	RU		
ban	RU	0	0
bca	RU		
bci	RU		
bdk	RU		
bel	RU		
bem	RU		
ben	RU		
bho	RU		
bin	RU		
bis	RU		
bod	RU		
bph	RU		
bre	RU		
bua	RU		
bul	RU	0	0
bxr	RU		
byf	RU		
car	RU		
ces	RU	0	0
che	RU		
chm	RU		
chu	RU	0	1
chv	RU	1	1
cji	RU		
cjs	RU	1	1
ckt	RU		
clw	RU	1	1
cop	RU	0	0
crh	RU	1	1
cym	RU	0	0
dan	RU	0	0
dar	RU		
ddo	RU		
deu	RU	0	0
div	RU	0	0
dlg	RU	1	1
dng	RU		
dta	RU		
dyu	RU		
egy	RU	0	0
ell	RU	0	0
enf	RU		
eng	RU	0	0
enh	RU		
epo	RU	1	1
ess	RU		
est	RU		
ett	RU		
eus	RU		
eve	RU	1	1
evn	RU	1	1
ewe	RU		
fao	RU	0	0
fas	RU	0	0
fat	RU		
fin	RU		
fon	RU		
fra	RU	0	0
fry	RU	0	0
ful	RU		
gag	RU	0	0
gcc	RU		
gdo	RU		
gin	RU		
gld	RU	1	1
gle	RU	0	0
grc	RU	0	0
gsw	RU	0	0
guj	RU	0	0
hat	RU	0	0
hau	RU	0	0
haw	RU	0	0
hbo	RU	0	0
hbs	RU	0	0
heb	RU	0	1
hin	RU	0	0
hit	RU	0	0
hni	RU		
hns	RU	0	0
hun	RU		
huz	RU		
hye	RU		
ibb	RU		
ibo	RU		
ido	RU	0	1
ina	RU	0	1
ind	RU		
inh	RU		
ipk	RU		
isl	RU		
ita	RU		
itl	RU		
izh	RU		
jbo	RU	0	1
jct	RU	0	0
jpn	RU		
kaa	RU	0	1
kan	RU		
kap	RU		
kas	RU		
kat	RU		
kau	RU		
kaz	RU	1	1
kbd	RU		
kca	RU		
kdr	RU	1	1
kea	RU		
ket	RU		
khm	RU	0	0
khv	RU		
kik	RU		
kim	RU	1	1
kin	RU		
kir	RU	0	1
kjh	RU	1	1
kjj	RU		
kmb	RU		
koi	RU		
kok	RU		
kom	RU		
kor	RU		
kpe	RU		
kpt	RU		
kpv	RU		
kpy	RU		
krc	RU	1	1
kri	RU		
krk	RU		
krl	RU		
kry	RU		
ktu	RU		
kum	RU	1	1
kur	RU		
kva	RU		
lad	RU		
lah	RU		
lao	RU		
lat	RU		
lav	RU		
lbe	RU		
lez	RU		
lij	RU		
lin	RU		
lit	RU		
liv	RU		
loz	RU		
ltz	RU		
lud	RU		
lug	RU		
lun	RU		
luo	RU		
lzz	RU		
mal	RU		
man	RU		
mar	RU		
mas	RU		
mdf	RU		
mfe	RU		
mhr	RU		
mkd	RU		
mlg	RU		
mlq	RU		
mlt	RU	0	0
mnc	RU	1	1
mni	RU		
mns	RU		
mon	RU		
mos	RU		
mri	RU		
mrj	RU		
msa	RU		
mtm	RU		
mud	RU		
mya	RU		
myv	RU		
naq	RU		
ndf	RU		
neg	RU	1	1
nep	RU		
nia	RU		
nio	RU		
niv	RU		
njo	RU		
nld	RU		
nog	RU	1	1
non	RU		
nor	RU		
nya	RU		
oaa	RU	1	1
oac	RU	1	1
ogo	RU		
olo	RU		
omk	RU		
oos	RU		
orm	RU	0	0
orv	RU		
oss	RU		
ota	RU	0	1
pan	RU		
pnt	RU		
pol	RU		
por	RU		
prs	RU		
pus	RU		
quc	RU		
que	RU		
qwm	RU	1	1
raj	RU		
rog	RU		
rom	RU	0	1
ron	RU	0	0
rop	RU		
rsl	RU		
rts	RU		
rue	RU		
rus	RU	1	1
rut	RU		
sag	RU		
sah	RU	1	1
san	RU	0	0
sco	RU		
sel	RU		
sgh	RU		
sia	RU		
sin	RU		
sjd	RU		
sjt	RU		
slk	RU		
slr	RU	0	1
slv	RU		
sme	RU		
smo	RU		
sna	RU		
snd	RU		
som	RU	0	0
sot	RU		
spa	RU	0	0
sqi	RU		
srp	RU		
ssw	RU		
sty	RU	1	1
sus	RU		
sux	RU		
sva	RU		
swa	RU	0	0
swc	RU	0	0
swe	RU		
syr	RU	0	1
tab	RU		
tam	RU		
tat	RU	1	1
tel	RU		
tgk	RU		
tgl	RU		
tha	RU		
tig	RU	0	0
tin	RU		
tir	RU	0	0
tkr	RU		
tly	RU		
tok	RU	0	0
tou	RU	1	1
tpi	RU		
tsn	RU		
ttt	RU		
tuk	RU	0	0
tur	RU	0	0
tyv	RU	1	1
ude	RU	1	1
udi	RU		
udm	RU		
ugh	RU		
uig	RU	0	1
ukr	RU		
ulc	RU	1	1
urd	RU		
uzb	RU	0	0
vep	RU		
vie	RU	0	0
vls	RU		
vot	RU		
wbl	RU		
wes	RU		
wol	RU		
xal	RU		
xas	RU		
xbo	RU	1	1
xcv	RU		
xdq	RU		
xln	RU		
xmf	RU		
xpm	RU		
xrm	RU	1	1
xrn	RU		
xsc	RU		
xwo	RU		
yah	RU		
yai	RU		
yid	RU		
ykg	RU		
ynk	RU		
yor	RU		
yrk	RU		
ysr	RU		
yua	RU		
yue	RU		
yug	RU		
yuu	RU		
yux	RU		
zgh	RU	0	0
zho	RU	0	1
zkh	RU	1	1
zko	RU		
zkz	RU	1	1
zul	RU		
eng	RW	0	0
fra	RW		
kin	RW	1	1
rsn	RW		
swa	RW	0	0
acw	SA	1	1
ara	SA	1	1
arb	SA	1	1
ars	SA	1	1
fif	SA	1	1
sdl	SA		
xna	SA	1	1
agw	SB	1	1
aia	SB	1	1
alu	SB	1	1
apb	SB	1	1
aua	SB	1	1
aud	SB	1	1
baa	SB	1	1
bgt	SB	1	1
blb	SB		
blp	SB	1	1
brr	SB	1	1
bvc	SB	1	1
bvd	SB	1	1
bxa	SB	1	1
dor	SB	1	1
eng	SB	0	0
faf	SB	1	1
far	SB	1	1
gga	SB	1	1
ghn	SB	1	1
gmb	SB	1	1
gri	SB	1	1
hoa	SB		
jaj	SB		
kji	SB		
kkk	SB		
ksg	SB		
kwd	SB		
kwf	SB		
kzk	SB		
lga	SB		
lgb	SB		
lgl	SB		
lgr	SB		
lgu	SB		
llu	SB		
lvk	SB		
mln	SB		
mlu	SB		
mnv	SB		
mpr	SB		
mrn	SB		
mte	SB		
mvo	SB		
nfl	SB		
ngr	SB		
nke	SB		
nlg	SB		
nlz	SB		
npx	SB		
ntu	SB		
ojv	SB		
ora	SB		
pis	SB		
piv	SB		
rri	SB		
rsi	SB	1	1
rug	SB		
sbb	SB		
sky	SB		
stn	SB		
svs	SB		
szs	SB		
tbe	SB		
tkp	SB		
tkw	SB		
tlr	SB		
tnx	SB		
tqu	SB		
tva	SB		
uge	SB		
utp	SB		
vnk	SB		
vrs	SB		
crs	SC		
eng	SC	0	0
fra	SC		
lsw	SC		
acz	SD		
aft	SD		
aja	SD		
apd	SD	1	1
ara	SD	0	1
atu	SD		
bdi	SD		
bej	SD	1	1
bot	SD		
brk	SD		
byg	SD		
byt	SD		
daj	SD		
dec	SD		
dgl	SD		
dil	SD		
drb	SD		
elh	SD		
eli	SD		
eng	SD	0	0
fia	SD		
fuj	SD		
fvr	SD		
ghl	SD		
gly	SD		
gza	SD		
hau	SD	0	1
hbn	SD		
jle	SD		
jum	SD		
kcp	SD		
kcr	SD		
kdu	SD		
kec	SD		
keg	SD		
kgo	SD		
kib	SD		
kko	SD		
laf	SD		
liu	SD		
lmd	SD		
lof	SD		
lro	SD		
mei	SD		
mls	SD		
mor	SD		
nyi	SD		
onw	SD		
otr	SD		
ras	SD		
shj	SD		
shw	SD		
soh	SD		
tag	SD		
taz	SD		
tbi	SD		
tbr	SD		
teq	SD		
tey	SD		
tic	SD		
tlo	SD		
tms	SD		
tqr	SD		
udu	SD		
wll	SD		
wrn	SD		
xmr	SD		
xom	SD		
xtc	SD		
zag	SD		
zmo	SD		
eng	SE	0	0
fin	SE		
fit	SE		
fra	SE		
ina	SE	0	1
non	SE		
ovd	SE		
rmu	SE		
rom	SE	0	0
sje	SE		
sju	SE		
sma	SE		
sme	SE		
smj	SE		
swe	SE	1	1
swl	SE		
yid	SE		
eng	SG	0	0
lah	SG	0	0
mal	SG	0	0
mbf	SG	0	0
msa	SG	1	1
pan	SG	0	0
sls	SG	1	0
tam	SG	0	0
zho	SG	0	0
eng	SH	0	0
bos	SI		
deu	SI		
eng	SI	0	0
fra	SI		
fur	SI		
hbs	SI		
hrv	SI		
hun	SI		
ita	SI		
nrc	SI		
rom	SI	0	1
slv	SI		
sqi	SI		
srp	SI		
vec	SI		
nob	SJ		
nor	SJ		
rus	SJ	0	0
ces	SK		
deu	SK		
eng	SK	0	0
fra	SK		
hun	SK		
pol	SK		
rmc	SK		
rom	SK	0	1
rsk	SK		
rue	SK		
slk	SK		
svk	SK		
ukr	SK		
bmf	SL		
bun	SL		
buy	SL		
eng	SL	0	0
ful	SL		
knk	SL		
kno	SL		
kri	SL		
lia	SL		
lok	SL		
men	SL		
sgx	SL		
tem	SL		
epo	SM	0	0
ita	SM		
ara	SN	0	1
bab	SN		
bam	SN		
bcb	SN		
bcz	SN		
bda	SN		
bjt	SN		
bqj	SN		
bsc	SN		
cae	SN		
cou	SN		
csk	SN		
cwt	SN		
dyo	SN		
fap	SN		
fra	SN		
fuc	SN		
ful	SN		
gsl	SN		
hhr	SN		
jad	SN		
knf	SN		
krx	SN		
lebu1234	SN		
man	SN		
mey	SN	1	1
mfv	SN		
mlo	SN		
mlq	SN		
mnk	SN		
ndv	SN		
pbp	SN		
sav	SN		
snf	SN		
snk	SN		
srr	SN		
tnr	SN		
wol	SN	1	1
yal	SN		
ara	SO	0	1
bnl	SO	1	1
dbr	SO	1	1
gex	SO	1	1
jii	SO	1	1
orm	SO	1	1
som	SO	1	1
swa	SO	0	1
tqq	SO	1	1
xma	SO		
ymm	SO	1	1
ako	SR		
arw	SR	1	1
djk	SR		
fra	SR		
hmn	SR		
hnj	SR		
hns	SR		
jvn	SR		
kww	SR		
njt	SR		
nld	SR		
sik	SR		
srm	SR		
srn	SR		
tri	SR		
way	SR		
zho	SR	0	0
ach	SS		
aja	SS		
ara	SS	0	0
atu	SS		
avu	SS		
bdh	SS		
bdj	SS		
bex	SS		
bfa	SS		
blm	SS		
bot	SS		
bvi	SS		
bxb	SS		
ddd	SS		
dib	SS		
did	SS		
dik	SS		
din	SS		
dip	SS		
diw	SS		
dks	SS		
eng	SS	0	0
fer	SS		
gbn	SS		
hom	SS		
idr	SS		
imt	SS		
kbo	SS		
koe	SS		
krs	SS		
lgo	SS		
lkr	SS		
lky	SS		
loh	SS		
lot	SS		
lpx	SS		
lqr	SS		
lul	SS		
lwo	SS		
mfz	SS		
mgc	SS		
mgd	SS		
mqu	SS		
muh	SS		
mur	SS		
mwu	SS		
myj	SS		
ndz	SS		
njl	SS		
nus	SS		
nwm	SS		
oie	SS		
pga	SS	1	1
shk	SS		
tex	SS		
tgy	SS		
thu	SS		
toq	SS		
ukv	SS		
xel	SS		
aoa	ST		
cri	ST		
fra	ST		
por	ST		
pre	ST		
ase	SV	0	0
ccr	SV		
csr	SV		
esn	SV		
len	SV		
ppl	SV		
spa	SV	0	0
eng	SX	0	0
nld	SX		
spa	SX	0	0
vic	SX		
amw	SY	1	1
apc	SY	1	1
ara	SY	0	1
arc	SY	1	1
ayp	SY	1	1
fra	SY		
hye	SY		
kmr	SY		
kur	SY		
lhs	SY	1	1
oar	SY	1	1
syc	SY	1	1
syr	SY	1	1
tru	SY	1	1
uga	SY	1	1
xeb	SY	1	1
xhu	SY		
eng	SZ	0	0
ssw	SZ		
tso	SZ		
zul	SZ		
eng	TA	0	0
eng	TC	0	0
tch	TC		
amj	TD		
ara	TD	0	1
arb	TD	0	1
bbz	TD		
bdm	TD	1	1
bdo	TD		
bes	TD		
bid	TD	1	1
bjv	TD		
bmi	TD		
bso	TD		
btf	TD	1	1
bub	TD		
bva	TD	1	1
bvf	TD	1	1
bvo	TD		
bxv	TD		
cds	TD		
ckq	TD	1	1
daa	TD	1	1
dai	TD		
dau	TD		
djc	TD		
dsi	TD		
dzg	TD		
fgr	TD		
fni	TD		
fra	TD		
fub	TD		
fui	TD		
ful	TD		
gab	TD	1	1
gdk	TD	1	1
gdm	TD		
gid	TD	1	1
glc	TD		
glj	TD		
glu	TD		
goy	TD		
gqr	TD		
gvl	TD		
hau	TD	0	1
hed	TD	1	1
hor	TD		
jeu	TD	1	1
jyy	TD		
kau	TD		
kbl	TD		
ker	TD	1	1
kia	TD		
kie	TD		
klf	TD		
knc	TD		
kou	TD		
kqp	TD	1	1
ksp	TD		
kth	TD		
kvf	TD	1	1
kvi	TD	1	1
kwg	TD		
kwv	TD		
kxj	TD		
kyq	TD		
lap	TD		
lln	TD	1	1
lme	TD	1	1
mcn	TD	1	1
mcw	TD	1	1
mde	TD		
mdg	TD		
mes	TD	1	1
mgb	TD		
mge	TD		
mje	TD	1	1
mlj	TD	1	1
mls	TD		
mmy	TD	1	1
mne	TD		
mou	TD	1	1
moz	TD	1	1
mpg	TD	1	1
mpk	TD	1	1
mse	TD	1	1
mua	TD		
mub	TD	1	1
mug	TD	1	1
muj	TD	1	1
mvh	TD	1	1
mvu	TD		
mwm	TD		
myb	TD		
ndm	TD	1	1
nie	TD		
nmc	TD		
nnc	TD	1	1
nnn	TD	1	1
noy	TD		
nzy	TD		
rou	TD		
saa	TD	1	1
sba	TD		
sbj	TD		
shu	TD	1	1
sjg	TD		
sok	TD	1	1
sor	TD	1	1
swy	TD	1	1
sys	TD		
tax	TD	1	1
tma	TD		
tmc	TD	1	1
tng	TD	1	1
trj	TD	1	1
tug	TD		
tui	TD		
tuq	TD		
ubi	TD	1	1
vkj	TD		
xuo	TD		
zag	TD		
zim	TD	1	1
zna	TD		
zrn	TD	1	1
fra	TF		
ade	TG		
adq	TG		
ahl	TG		
aks	TG		
ayg	TG		
blo	TG		
bqg	TG		
bud	TG		
ewe	TG		
fra	TG		
gej	TG		
gng	TG		
ife	TG		
kbp	TG		
kdh	TG		
kef	TG		
keu	TG		
kpo	TG		
las	TG		
mfq	TG		
nmz	TG		
wci	TG		
wud	TG		
ahk	TH		
bfk	TH		
brv	TH	1	1
bzi	TH		
cbn	TH	1	1
cog	TH	1	1
csd	TH		
eng	TH	0	0
fra	TH		
hmn	TH		
hnj	TH		
jpn	TH		
kdt	TH	1	1
kjg	TH	0	1
kjt	TH		
ksw	TH		
kxm	TH	1	1
lao	TH		
lcp	TH	1	1
lhu	TH		
lis	TH		
lwl	TH	1	1
meo	TH		
mfa	TH		
mkm	TH		
mnw	TH	1	1
mpz	TH		
mra	TH	1	1
msa	TH		
mya	TH		
nod	TH		
nyl	TH	1	1
nyw	TH		
pht	TH		
phu	TH		
pli	TH		
prt	TH	1	1
pww	TH		
scq	TH	1	1
shn	TH		
shy	TH	0	0
skb	TH		
soa	TH		
sou	TH		
tha	TH	1	1
thm	TH	1	1
tnz	TH	1	1
tsq	TH		
tts	TH	1	1
ugo	TH		
urk	TH		
yao	TH		
yno	TH		
yoy	TH		
zho	TH	0	0
zlm	TH		
abh	TJ	1	1
ara	TJ	0	1
fas	TJ	0	1
kir	TJ	1	1
paq	TJ		
rus	TJ	0	0
sgh	TJ		
tgk	TJ	1	1
uzb	TJ	1	1
yah	TJ		
yai	TJ		
eng	TK	0	0
gil	TK	0	0
smo	TK		
tkl	TK		
tvl	TK		
adb	TL		
aoz	TL	1	1
bfn	TL		
bkx	TL	1	1
ddg	TL		
gal	TL	1	1
hbu	TL	1	1
idt	TL		
ilu	TL		
kem	TL		
krd	TL		
lka	TL		
llg	TL		
lva	TL		
mgm	TL		
mjb	TL		
mkz	TL		
nil	TL		
nxa	TL		
por	TL		
tdt	TL		
tet	TL		
tkd	TL		
tvy	TL		
wlh	TL		
wmh	TL		
chg	TM	1	1
kaa	TM	1	1
kur	TM		
rus	TM	0	0
tuk	TM	1	1
uzb	TM	1	1
aeb	TN	1	1
ara	TN	0	1
arb	TN	0	1
fra	TN		
jbn	TN	1	1
nxm	TN		
pml	TN		
sds	TN	1	1
shy	TN	1	1
tse	TN		
xpu	TN	1	1
eng	TO	0	0
nkp	TO		
num	TO		
ton	TO		
abk	TR	0	0
ady	TR		
apc	TR	1	1
ara	TR	0	1
ayp	TR	1	1
aze	TR	1	1
bgx	TR	1	1
bul	TR		
diq	TR		
dsz	TR		
ell	TR		
eng	TR	0	0
hit	TR		
hlu	TR		
hrt	TR	1	1
htx	TR		
hye	TR		
imy	TR		
kaa	TR	0	1
kat	TR		
kaz	TR	0	1
kbd	TR		
kir	TR	0	1
kiu	TR		
kmr	TR		
kur	TR		
lzz	TR		
nei	TR		
oht	TR		
ota	TR	1	1
plq	TR		
pnt	TR		
sqi	TR		
srp	TR		
syc	TR	1	1
tru	TR	1	1
tsm	TR		
tur	TR	1	1
txh	TR		
uby	TR		
uzb	TR	0	0
xcr	TR		
xga	TR		
xht	TR		
xlc	TR		
xld	TR		
xpg	TR		
xps	TR		
xsd	TR		
xur	TR		
yms	TR		
zsk	TR		
zza	TR		
eng	TT	0	0
lst	TT		
spa	TT	0	0
tgh	TT		
trf	TT		
eng	TV	0	0
tvl	TV		
ami	TW	1	1
bnn	TW	1	1
byq	TW	1	1
bzg	TW	1	1
ckv	TW	1	1
cmn	TW	0	0
dru	TW	1	1
fos	TW	1	1
hak	TW		
kae	TW		
nan	TW	0	0
ppu	TW		
pwn	TW		
pyu	TW		
pzh	TW		
ssf	TW		
sxr	TW		
szy	TW		
tao	TW		
tay	TW		
trv	TW		
tss	TW		
tsu	TW		
tvx	TW		
uon	TW		
xnb	TW		
xsy	TW		
ycr	TW		
zho	TW	0	0
aas	TZ	1	1
asa	TZ	1	1
bdp	TZ		
bds	TZ	1	1
bez	TZ		
bou	TZ		
ccl	TZ	1	1
cwa	TZ		
cwe	TZ		
dhs	TZ		
dig	TZ		
dne	TZ		
doe	TZ		
egm	TZ		
eng	TZ	0	0
fip	TZ		
gmx	TZ		
gog	TZ		
gow	TZ	1	1
guj	TZ		
gwe	TZ		
han	TZ		
haq	TZ		
hay	TZ		
heh	TZ		
hka	TZ		
hts	TZ		
ikz	TZ		
irk	TZ	1	1
isn	TZ		
jit	TZ		
jmc	TZ		
kcu	TZ		
kcz	TZ		
kdc	TZ		
kde	TZ		
ked	TZ		
kiv	TZ		
kiz	TZ		
kki	TZ		
kqh	TZ		
ksb	TZ		
kuj	TZ		
kya	TZ		
lag	TZ		
luo	TZ		
mas	TZ		
mgh	TZ		
mgq	TZ		
mgs	TZ		
mgv	TZ		
mgw	TZ		
mgy	TZ		
mgz	TZ		
mhd	TZ		
mjh	TZ		
mpa	TZ		
mvw	TZ		
mwe	TZ		
mwn	TZ		
ndg	TZ		
ndh	TZ		
ndj	TZ		
ngp	TZ		
ngq	TZ		
nih	TZ		
nim	TZ		
njd	TZ		
nkt	TZ		
nnq	TZ		
now	TZ		
nsg	TZ		
ntk	TZ		
nww	TZ		
nxi	TZ		
nym	TZ		
nyy	TZ		
old	TZ		
pbr	TZ		
piw	TZ		
poy	TZ		
reg	TZ		
rim	TZ		
rnw	TZ		
rof	TZ		
ruf	TZ		
rui	TZ		
rwk	TZ		
rwl	TZ		
sad	TZ		
sbk	TZ		
sbm	TZ		
sbp	TZ		
seg	TZ		
soz	TZ		
ssc	TZ		
suj	TZ		
suk	TZ		
suw	TZ		
swa	TZ	1	1
swh	TZ	1	1
tcc	TZ		
tny	TZ		
tza	TZ		
vid	TZ		
vin	TZ		
vun	TZ		
wbh	TZ		
wbi	TZ		
wbj	TZ	1	1
wka	TZ	1	1
wtb	TZ		
wun	TZ		
xnj	TZ		
xsj	TZ		
yao	TZ		
ymk	TZ		
zaj	TZ		
zak	TZ		
zga	TZ		
zin	TZ		
ziw	TZ		
bel	UA		
bul	UA		
crh	UA	1	1
deu	UA		
ell	UA		
fra	UA		
gag	UA	1	1
got	UA		
heb	UA	0	1
hun	UA		
hye	UA		
jct	UA	1	1
kdr	UA	1	1
pol	UA		
rom	UA	0	1
ron	UA	0	1
rue	UA		
rus	UA	0	1
slk	UA		
tat	UA	0	1
tur	UA	0	1
ukl	UA		
ukr	UA	1	1
uum	UA	1	1
xpc	UA	1	1
ydd	UA		
yid	UA		
ach	UG		
adh	UG		
cgg	UG		
eng	UG	0	0
gwr	UG		
hin	UG		
ikx	UG		
kcn	UG	1	1
kdi	UG		
kdj	UG		
keo	UG		
kin	UG		
kln	UG		
koo	UG		
kpz	UG		
laj	UG		
lgg	UG		
lke	UG		
lsm	UG		
lth	UG		
luc	UG		
lug	UG		
luy	UG		
mhi	UG		
myx	UG		
ndp	UG		
nuj	UG		
nyn	UG		
nyo	UG		
nyp	UG		
rub	UG		
ruc	UG		
rwm	UG		
snm	UG		
spy	UG		
swa	UG	0	0
teo	UG		
teu	UG		
tlj	UG		
ttj	UG		
ugn	UG		
xog	UG		
eng	UM	0	0
aaq	US	1	1
abe	US		
ace	US	0	0
acv	US		
aes	US	1	1
afr	US	0	0
aht	US		
aii	US	0	0
aka	US	0	0
akz	US		
ale	US		
alq	US		
amh	US	0	0
apj	US		
apk	US		
apl	US		
apm	US		
apw	US		
aqp	US	1	1
ara	US	0	0
ari	US	1	1
arn	US	0	0
arp	US	1	1
arw	US	0	0
ase	US	1	0
ask	US		
asm	US		
ats	US		
atw	US		
aym	US		
aze	US	0	0
bal	US		
bam	US		
ban	US	0	0
bel	US		
ben	US		
bho	US		
bik	US	0	0
bla	US		
bll	US		
bod	US		
boi	US		
bos	US		
bre	US		
bsk	US		
bul	US		
cad	US		
cal	US	0	0
cat	US		
cay	US		
cea	US		
ceb	US	0	0
ces	US		
cha	US	0	0
chb	US		
chc	US		
chh	US		
chk	US	0	0
chl	US		
chn	US		
cho	US		
chr	US		
chy	US		
cic	US		
cid	US		
ciw	US		
cja	US	0	0
cjh	US		
cku	US		
cld	US	0	0
clm	US		
cmm	US		
cmn	US		
coc	US		
col	US		
com	US		
coq	US		
cow	US		
crd	US		
cre	US		
crg	US		
cro	US		
crr	US		
crz	US		
csi	US		
csm	US		
css	US		
cst	US		
csz	US		
ctc	US		
ctm	US		
cup	US		
cym	US		
dak	US		
dan	US		
del	US		
dep	US		
deu	US		
dih	US		
ell	US		
ems	US		
eng	US	0	0
epo	US	0	0
esi	US		
esk	US		
esq	US		
ess	US		
est	US		
esu	US		
etc	US		
eus	US		
eya	US		
fao	US		
fas	US	0	0
fij	US	0	0
fil	US	0	0
fin	US		
fla	US		
fra	US		
frc	US		
fry	US		
ful	US		
gaa	US		
gce	US		
gej	US		
gil	US	0	0
gla	US		
gle	US		
gon	US		
grn	US		
gsw	US		
guj	US		
gul	US		
gur	US		
gwi	US		
haa	US		
hai	US		
hak	US		
hat	US		
hau	US	0	0
haw	US	1	1
hbs	US		
heb	US	0	0
hid	US		
hin	US		
hmn	US		
hnj	US		
hoi	US		
hop	US		
hps	US		
hrv	US		
hsb	US		
hsn	US		
hun	US		
hup	US		
hwc	US		
hye	US		
hyw	US		
ibo	US		
ido	US	0	0
ilo	US		
iml	US		
ina	US	1	1
ind	US		
ing	US		
inz	US		
iow	US		
ipk	US		
isl	US		
ita	US		
ium	US		
jam	US		
jav	US		
jbo	US	1	1
jpn	US		
kaa	US	0	0
kac	US		
kan	US		
kas	US		
kau	US		
kaz	US	0	0
kea	US		
kee	US		
khm	US	0	0
kic	US		
kii	US		
kio	US		
kir	US	0	0
kjb	US		
kjq	US		
kju	US		
kla	US		
kok	US		
kor	US		
kos	US		
koy	US		
krb	US		
krc	US	0	0
kri	US		
ksk	US		
ksw	US		
ktw	US		
kur	US		
kut	US		
kuu	US		
kwk	US		
kyh	US		
kyl	US		
lad	US		
lah	US		
lao	US		
lav	US		
lit	US		
lkt	US		
lmw	US		
lmz	US		
lou	US		
ltz	US		
lug	US		
lui	US		
lus	US		
lut	US		
mah	US		
mal	US		
mar	US		
mbe	US		
mdd	US		
mez	US		
mfz	US		
mhm	US		
mhq	US		
mia	US		
mic	US		
mik	US		
min	US		
miq	US		
mjd	US		
mjy	US		
mkd	US		
mkj	US		
mkq	US		
mlg	US		
mmm	US		
mnr	US		
mod	US		
moh	US		
mon	US		
mov	US		
mrc	US		
mre	US		
mri	US		
mrl	US		
mrq	US		
msa	US		
mus	US		
mvb	US		
mww	US		
mya	US		
myh	US		
nan	US		
nau	US		
nav	US		
ncz	US		
nep	US		
nez	US		
niu	US		
nkr	US		
nld	US		
nmu	US		
nnt	US		
nok	US		
nol	US		
nor	US		
nrt	US		
nsq	US		
nsz	US		
ntw	US		
nuk	US		
nwa	US		
nwy	US		
obi	US		
ofo	US		
oji	US		
oka	US		
oma	US		
one	US		
ono	US		
ood	US		
ori	US		
orm	US	0	0
osa	US		
oss	US		
otw	US		
pag	US		
pam	US		
pan	US		
pao	US		
pap	US		
par	US		
pau	US		
paw	US		
pdc	US		
peb	US		
pef	US		
pej	US		
peq	US		
pes	US		
pia	US		
pie	US		
pif	US		
pim	US		
pmw	US		
pol	US		
pom	US		
pon	US		
poo	US		
por	US		
pot	US		
pqm	US		
prs	US		
psd	US		
psy	US		
pus	US		
puy	US		
pwi	US		
qua	US		
que	US		
qui	US		
qun	US		
qwt	US		
qyp	US		
raj	US		
rar	US		
roh	US		
rom	US	0	0
ron	US	0	0
rus	US	0	0
sac	US		
see	US		
ser	US		
shh	US		
shs	US		
sht	US		
sin	US		
sis	US		
sjw	US		
ska	US		
skd	US		
slh	US		
slk	US		
sln	US		
slv	US		
sme	US		
smo	US		
sna	US		
snd	US		
sno	US		
som	US	0	0
spa	US	0	0
spo	US		
sqi	US		
sqn	US		
srm	US		
srp	US		
sun	US		
swa	US	0	0
swe	US		
sxk	US		
syr	US	0	0
taa	US		
tam	US		
tau	US		
tcb	US		
tel	US		
tew	US		
tfn	US		
tgk	US		
tgl	US		
tha	US		
til	US		
tir	US	0	0
tix	US		
tjm	US		
tkl	US		
tkm	US		
tlh	US	1	0
tli	US		
tol	US		
ton	US		
tow	US		
tqn	US		
tqw	US		
tsi	US		
tsz	US		
tta	US		
tub	US		
tuk	US	0	0
tun	US		
tur	US	0	0
tus	US		
tuu	US		
twa	US		
twf	US		
twi	US		
txc	US		
uig	US	0	0
ukr	US		
uli	US		
uma	US		
unm	US		
unx	US		
urd	US		
ute	US		
veo	US		
vie	US	0	0
vmv	US		
waa	US		
wac	US		
wam	US		
wao	US		
was	US		
wic	US		
win	US		
wiy	US		
wlk	US		
wnw	US		
woe	US		
wol	US		
wuu	US		
wya	US		
wyn	US		
xad	US	1	1
xap	US		
xaw	US		
xch	US		
xcn	US		
xcw	US		
xcy	US		
xgf	US		
xgr	US		
xlb	US		
xlo	US		
xnt	US		
xpq	US		
xrt	US		
xup	US		
xwc	US		
yak	US		
yap	US		
yaq	US		
ydd	US		
yid	US		
yih	US		
ynn	US		
yok	US		
yor	US		
yuc	US		
yue	US		
yuf	US		
yuk	US		
yum	US		
yur	US		
zap	US		
zgh	US	0	0
zho	US	0	0
zkk	US		
zun	US		
fra	UY		
spa	UY	0	0
ugy	UY		
ara	UZ	0	1
auz	UZ	1	1
bhh	UZ		
kaa	UZ	1	1
paq	UZ		
rus	UZ	0	0
sog	UZ		
tur	UZ	0	0
uzb	UZ	1	1
uzn	UZ	1	1
xco	UZ		
ita	VA		
lat	VA		
crb	VC		
eng	VC	0	0
svc	VC		
aoc	VE		
bae	VE		
bvv	VE		
bwi	VE		
car	VE		
ciy	VE		
cuo	VE		
gae	VE		
gct	VE		
guu	VE		
jru	VE		
mcg	VE		
mch	VE		
mht	VE		
pbg	VE		
pbh	VE		
pev	VE		
pid	VE		
spa	VE	0	0
spc	VE		
tmz	VE		
vsl	VE		
wba	VE		
wpc	VE		
xak	VE		
xsu	VE		
yae	VE		
yar	VE		
yau	VE		
yrl	VE		
yvt	VE		
dcr	VG		
eng	VG	0	0
vic	VG		
dcr	VI		
eng	VI	0	0
fra	VI		
aem	VN	1	1
ahk	VN		
bdq	VN	1	1
blt	VN		
brb	VN	1	1
bru	VN	1	1
cja	VN	1	1
cje	VN	1	1
cjm	VN	1	1
cma	VN	1	1
cmo	VN	1	1
cnc	VN		
cnp	VN		
crw	VN	1	1
csp	VN		
cua	VN	1	1
enc	VN		
fra	VN		
gio	VN		
giq	VN		
gir	VN		
giw	VN		
hab	VN		
haf	VN		
hak	VN		
hal	VN	1	1
hld	VN	1	1
hmf	VN		
hmn	VN		
hmv	VN		
hmz	VN		
hni	VN		
hnj	VN		
hnu	VN	1	1
hos	VN		
hre	VN	1	1
hro	VN		
ibh	VN		
iii	VN		
ium	VN		
jeh	VN	1	1
jra	VN		
khb	VN		
khm	VN	1	1
kjg	VN	0	1
kjm	VN	1	1
kpm	VN	1	1
kta	VN	1	1
ktv	VN	1	1
kxy	VN	1	1
lao	VN		
laq	VN		
lbt	VN		
lgh	VN		
lha	VN		
lhu	VN		
lkc	VN		
lwh	VN		
mji	VN		
mlc	VN		
mng	VN	1	1
mnn	VN	1	1
moo	VN	1	1
mtq	VN	1	1
mww	VN		
nan	VN		
neo	VN		
nty	VN		
nuo	VN	1	1
nut	VN		
ocm	VN		
oog	VN	1	1
pac	VN	1	1
pcc	VN		
pdi	VN		
pha	VN		
phg	VN	1	1
phh	VN		
pho	VN		
pht	VN		
pkt	VN	1	1
puo	VN	1	1
rad	VN		
ren	VN	1	1
rgs	VN		
rmx	VN	1	1
roc	VN		
rog	VN		
scb	VN	1	1
sed	VN	1	1
slt	VN		
stg	VN	1	1
sti	VN	1	1
stt	VN	1	1
swi	VN		
tas	VN		
tdd	VN		
tdr	VN	1	1
tkz	VN	1	1
tmm	VN		
tou	VN	1	1
tpo	VN		
tsl	VN		
tth	VN	1	1
twh	VN		
tyh	VN	1	1
tyj	VN		
tyl	VN		
tyr	VN		
tys	VN		
tyt	VN		
tyz	VN		
vie	VN	1	1
xao	VN		
xhv	VN		
yue	VN		
zha	VN		
zhd	VN		
zho	VN	0	1
zng	VN	1	1
zyg	VN		
zyn	VN		
zzj	VN		
ahb	VU	1	1
akr	VU	1	1
alm	VU	1	1
aor	VU	1	1
app	VU	1	1
aty	VU	1	1
aul	VU	1	1
bis	VU		
bki	VU	1	1
bnk	VU	1	1
bnr	VU	1	1
bpa	VU	1	1
brj	VU	1	1
btr	VU	1	1
crc	VU	1	1
dix	VU	1	1
eng	VU	0	0
erg	VU	1	1
erk	VU	1	1
etn	VU	1	1
fnb	VU	1	1
fra	VU		
frt	VU	1	1
fut	VU	1	1
hiw	VU	1	1
iff	VU		
klv	VU		
kol	VU		
krf	VU		
lgk	VU		
lht	VU		
lkn	VU		
llp	VU		
lmb	VU		
lml	VU		
lmu	VU		
lnn	VU		
lpa	VU		
lrv	VU		
lrz	VU		
lww	VU		
lzl	VU		
mkv	VU		
mla	VU		
mll	VU		
mlv	VU		
mlx	VU		
mme	VU		
mmg	VU		
mmm	VU		
mmw	VU		
mnl	VU		
mrb	VU		
mrm	VU		
mrp	VU		
mrs	VU		
msn	VU		
mtt	VU		
mvt	VU		
mwi	VU		
mwo	VU		
mxe	VU		
nkk	VU		
nmb	VU		
nmk	VU		
nms	VU		
nnd	VU		
nrg	VU		
nsw	VU		
nvh	VU		
nwi	VU		
olr	VU		
omb	VU		
onu	VU		
pgk	VU		
plb	VU		
pma	VU		
psw	VU		
ptr	VU		
ptv	VU		
rga	VU		
rpn	VU		
sax	VU		
ske	VU		
sku	VU		
sns	VU		
ssv	VU		
sww	VU		
tgp	VU		
tgs	VU		
tlm	VU		
tls	VU		
tmb	VU		
tmi	VU		
tmt	VU		
tnk	VU		
tnl	VU		
tnn	VU		
tnp	VU		
tql	VU		
tsr	VU		
tvk	VU		
upv	VU		
urr	VU		
uur	VU		
vao	VU		
vlp	VU		
vnm	VU		
vnp	VU		
vra	VU		
vrt	VU		
wlr	VU		
wsi	VU		
wwo	VU		
fra	WF		
fud	WF	1	1
wls	WF		
eng	WS	0	0
smo	WS		
aln	XK		
fra	XK		
hbs	XK		
sqi	XK		
srp	XK		
acq	YE	1	1
ara	YE	1	1
ayh	YE	1	1
ayn	YE	1	1
eng	YE	0	0
gdq	YE	1	1
inm	YE	1	1
jye	YE	1	1
rzh	YE	1	1
sqt	YE	1	1
xha	YE	1	1
xhd	YE	1	1
xqt	YE	1	1
xsa	YE	1	1
ara	YT	0	1
buc	YT	1	1
fra	YT		
mlg	YT		
swa	YT	1	1
swb	YT		
wlc	YT		
wni	YT		
zdj	YT		
afr	ZA	1	0
brl	ZA		
cmt	ZA		
eng	ZA	0	0
fly	ZA		
fng	ZA		
gic	ZA		
gku	ZA		
hin	ZA		
knw	ZA		
kqu	ZA		
kqz	ZA		
naq	ZA		
nbl	ZA		
ngh	ZA		
nsb	ZA		
nso	ZA		
oor	ZA		
por	ZA		
rng	ZA		
sfs	ZA		
sot	ZA		
ssw	ZA		
swa	ZA	0	0
tam	ZA		
tsc	ZA		
tsn	ZA		
tso	ZA		
urd	ZA		
ven	ZA		
xam	ZA		
xeg	ZA		
xho	ZA	1	1
xii	ZA		
ydd	ZA		
yid	ZA		
zul	ZA	1	1
auh	ZM		
bem	ZM		
bwc	ZM		
dov	ZM		
eng	ZM	0	0
ilb	ZM		
kqn	ZM		
lam	ZM		
leb	ZM		
leh	ZM		
loz	ZM		
lue	ZM		
lun	ZM		
lyn	ZM		
mck	ZM		
mgr	ZM		
mho	ZM		
mwn	ZM		
mxo	ZM		
nka	ZM		
nse	ZM		
nya	ZM		
sby	ZM		
shq	ZM		
sie	ZM		
sta	ZM		
toi	ZM		
ttl	ZM		
tum	ZM		
xnj	ZM		
zsl	ZM		
dov	ZW		
eng	ZW	0	0
kck	ZW		
kdn	ZW		
mxc	ZW		
ndc	ZW		
nde	ZW		
nmq	ZW		
nya	ZW		
sna	ZW	1	1
tsn	ZW		
ven	ZW		
zib	ZW		