From https://documentation.abes.fr/guide/html/formats/CodesLanguesISO639-3.htm		
Code	Nom en français	Display Name French
aaa	ghotuo	Ghotuo
aab	alumu-tesu	Alumu-Tesu
aac	ari	Ari
aad	amal	Amal
aae	arbëreshë albanian	Arbëreshë Albanian
aaf	aranadan	Aranadan
aag	ambrak	Ambrak
aah	abu' arapesh	Abu' Arapesh
aai	arifama-miniafia	Arifama-Miniafia
aak	ankave	Ankave
aal	afade	Afade
aan	anambé	Anambé
aao	algerian saharan arabic	Algerian Saharan Arabic
aap	pará arára	Pará Arára
aaq	eastern abnaki	Eastern Abnaki
aar	afar	Afar
aas	aasáx	Aasáx
aat	arvanitika albanian	Arvanitika Albanian
aau	abau	Abau
aaw	solong	Solong
aax	mandobo atas	Mandobo Atas
aaz	amarasi	Amarasi
aba	abé	Abé
abb	bankon	Bankon
abc	ambala ayta	Ambala Ayta
abd	manide	Manide
abe	western abnaki	Western Abnaki
abf	abai sungai	Abai Sungai
abg	abaga	Abaga
abh	tajiki arabic	Tajiki Arabic
abi	abidji	Abidji
abj	aka-bea	Aka-Bea
abk	abkhaze	Abkhaze
abl	lampung nyo	Lampung Nyo
abm	abanyom	Abanyom
abn	abua	Abua
abo	abon	Abon
abp	abellen ayta	Abellen Ayta
abq	abaza	Abaza
abr	abron	Abron
abs	ambonese malay	Ambonese Malay
abt	ambulas	Ambulas
abu	abure	Abure
abv	baharna arabic	Baharna Arabic
abw	pal	Pal
abx	inabaknon	Inabaknon
aby	aneme wake	Aneme Wake
abz	abui	Abui
aca	achagua	Achagua
acb	áncá	Áncá
acd	gikyode	Gikyode
ace	aceh	Aceh
acf	saint lucian creole french	Saint Lucian Creole French
ach	acoli	Acoli
aci	aka-cari	Aka-Cari
ack	aka-kora	Aka-Kora
acl	akar-bale	Akar-Bale
acm	mesopotamian arabic	Mesopotamian Arabic
acn	achang	Achang
acp	eastern acipa	Eastern Acipa
acq	ta'izzi-adeni arabic	Ta'Izzi-Adeni Arabic
acr	achi	Achi
acs	acroá	Acroá
act	achterhoeks	Achterhoeks
acu	achuar-shiwiar	Achuar-Shiwiar
acv	achumawi	Achumawi
acw	hijazi arabic	Hijazi Arabic
acx	omani arabic	Omani Arabic
acy	cypriot arabic	Cypriot Arabic
acz	acheron	Acheron
ada	adangme	Adangme
adb	atauran	Atauran
add	lidzonka	Lidzonka
ade	adele	Adele
adf	dhofari arabic	Dhofari Arabic
adg	andegerebinha	Andegerebinha
adh	adhola	Adhola
adi	adi	Adi
adj	adioukrou	Adioukrou
adl	galo	Galo
adn	adang	Adang
ado	abu	Abu
adq	adangbe	Adangbe
adr	adonara	Adonara
ads	adamorobe sign language	Adamorobe Sign Language
adt	adnyamathanha	Adnyamathanha
adu	aduge	Aduge
adw	amundava	Amundava
adx	amdo tibetan	Amdo Tibetan
ady	adyghé	Adyghé
adz	adzera	Adzera
aea	areba	Areba
aeb	tunisian arabic	Tunisian Arabic
aec	saidi arabic	Saidi Arabic
aed	argentine sign language	Argentine Sign Language
aee	northeast pashai	Northeast Pashai
aek	haeke	Haeke
ael	ambele	Ambele
aem	arem	Arem
aen	armenian sign language	Armenian Sign Language
aeq	aer	Aer
aer	eastern arrernte	Eastern Arrernte
aes	alsea	Alsea
aeu	akeu	Akeu
aew	ambakich	Ambakich
aey	amele	Amele
aez	aeka	Aeka
afa	afro-asiatiques, langues	Afro-Asiatiques, Langues
afb	gulf arabic	Gulf Arabic
afd	andai	Andai
afe	putukwam	Putukwam
afg	afghan sign language	Afghan Sign Language
afh	afrihili	Afrihili
afi	akrukay	Akrukay
afk	nanubae	Nanubae
afn	defaka	Defaka
afo	eloyi	Eloyi
afp	tapei	Tapei
afr	afrikaans	Afrikaans
afs	afro-seminole creole	Afro-Seminole Creole
aft	afitti	Afitti
afu	awutu	Awutu
afz	obokuitai	Obokuitai
aga	aguano	Aguano
agb	legbo	Legbo
agc	agatu	Agatu
agd	agarabi	Agarabi
age	angal	Angal
agf	arguni	Arguni
agg	angor	Angor
agh	ngelima	Ngelima
agi	agariya	Agariya
agj	argobba	Argobba
agk	isarog agta	Isarog Agta
agl	fembe	Fembe
agm	angaataha	Angaataha
agn	agutaynen	Agutaynen
ago	tainae	Tainae
agq	aghem	Aghem
agr	aguaruna	Aguaruna
ags	esimbi	Esimbi
agt	central cagayan agta	Central Cagayan Agta
agu	aguacateco	Aguacateco
agv	remontado dumagat	Remontado Dumagat
agw	kahua	Kahua
agx	aghul	Aghul
agy	southern alta	Southern Alta
agz	mt. iriga agta	Mt. Iriga Agta
aha	ahanta	Ahanta
ahb	axamb	Axamb
ahg	qimant	Qimant
ahh	aghu	Aghu
ahi	tiagbamrin aizi	Tiagbamrin Aizi
ahk	akha	Akha
ahl	igo	Igo
ahm	mobumrin aizi	Mobumrin Aizi
ahn	ŕhŕn	Ŕhŕn
aho	ahom	Ahom
ahp	aproumu aizi	Aproumu Aizi
ahr	ahirani	Ahirani
ahs	ashe	Ashe
aht	ahtena	Ahtena
aia	arosi	Arosi
aib	ainu (china)	Ainu (China)
aic	ainbai	Ainbai
aid	alngith	Alngith
aie	amara	Amara
aif	agi	Agi
aig	antigua and barbuda creole english	Antigua And Barbuda Creole English
aih	ai-cham	Ai-Cham
aii	assyrian neo-aramaic	Assyrian Neo-Aramaic
aij	lishanid noshan	Lishanid Noshan
aik	ake	Ake
ail	aimele	Aimele
aim	aimol	Aimol
ain	aïnou	Aïnou
aio	aiton	Aiton
aip	burumakok	Burumakok
aiq	aimaq	Aimaq
air	airoran	Airoran
ait	arikem	Arikem
aiw	aari	Aari
aix	aighon	Aighon
aiy	ali	Ali
aja	aja (south sudan)	Aja (South Sudan)
ajg	aja (benin)	Aja (Benin)
aji	ajië	Ajië
ajn	andajin	Andajin
ajp	south levantine arabic	South Levantine Arabic
ajs	algerian jewish sign language	Algerian Jewish Sign Language
aju	judeo-moroccan arabic	Judeo-Moroccan Arabic
ajw	ajawa	Ajawa
ajz	amri karbi	Amri Karbi
aka	akan	Akan
akb	batak angkola	Batak Angkola
akc	mpur	Mpur
akd	ukpet-ehom	Ukpet-Ehom
ake	akawaio	Akawaio
akf	akpa	Akpa
akg	anakalangu	Anakalangu
akh	angal heneng	Angal Heneng
aki	aiome	Aiome
akj	aka-jeru	Aka-Jeru
akk	akkadien	Akkadien
akl	aklanon	Aklanon
akm	aka-bo	Aka-Bo
ako	akurio	Akurio
akp	siwu	Siwu
akq	ak	Ak
akr	araki	Araki
aks	akaselem	Akaselem
akt	akolet	Akolet
aku	akum	Akum
akv	akhvakh	Akhvakh
akw	akwa	Akwa
akx	aka-kede	Aka-Kede
aky	aka-kol	Aka-Kol
akz	alabama	Alabama
ala	alago	Alago
alc	qawasqar	Qawasqar
ald	alladian	Alladian
ale	aléoute	Aléoute
alf	alege	Alege
alg	algonquines, langues	Algonquines, Langues
alh	alawa	Alawa
ali	amaimon	Amaimon
alj	alangan	Alangan
alk	alak	Alak
all	allar	Allar
alm	amblong	Amblong
aln	gheg albanian	Gheg Albanian
alo	larike-wakasihu	Larike-Wakasihu
alp	alune	Alune
alq	algonquin	Algonquin
alr	alutor	Alutor
als	tosk albanian	Tosk Albanian
alt	altaï du sud	Altaï Du Sud
alu	are'are	Are'Are
alw	alaba-k’abeena	Alaba-K’Abeena
alx	amol	Amol
aly	alyawarr	Alyawarr
alz	alur	Alur
ama	amanayé	Amanayé
amb	ambo	Ambo
amc	amahuaca	Amahuaca
ame	yanesha'	Yanesha'
amf	hamer-banna	Hamer-Banna
amg	amurdak	Amurdak
amh	amharique	Amharique
ami	amis	Amis
amj	amdang	Amdang
amk	ambai	Ambai
aml	war-jaintia	War-Jaintia
amm	ama (papua new guinea)	Ama (Papua New Guinea)
amn	amanab	Amanab
amo	amo	Amo
amp	alamblak	Alamblak
amq	amahai	Amahai
amr	amarakaeri	Amarakaeri
ams	southern amami-oshima	Southern Amami-Oshima
amt	amto	Amto
amu	guerrero amuzgo	Guerrero Amuzgo
amv	ambelau	Ambelau
amw	western neo-aramaic	Western Neo-Aramaic
amx	anmatyerre	Anmatyerre
amy	ami	Ami
amz	atampaya	Atampaya
ana	andaqui	Andaqui
anb	andoa	Andoa
anc	ngas	Ngas
and	ansus	Ansus
ane	xârâcůů	Xârâcůů
anf	animere	Animere
ang	anglo-saxon (450-1100)	Anglo-Saxon (450-1100)
anh	nend	Nend
ani	andi	Andi
anj	anor	Anor
ank	goemai	Goemai
anl	anu-hkongso chin	Anu-Hkongso Chin
anm	anal	Anal
ann	obolo	Obolo
ano	andoque	Andoque
anp	angika	Angika
anq	jarawa (india)	Jarawa (India)
anr	andh	Andh
ans	anserma	Anserma
ant	antakarinya	Antakarinya
anu	anuak	Anuak
anv	denya	Denya
anw	anaang	Anaang
anx	andra-hus	Andra-Hus
any	anyin	Anyin
anz	anem	Anem
aoa	angolar	Angolar
aob	abom	Abom
aoc	pemon	Pemon
aod	andarum	Andarum
aoe	angal enen	Angal Enen
aof	bragat	Bragat
aog	angoram	Angoram
aoi	anindilyakwa	Anindilyakwa
aoj	mufian	Mufian
aok	arhö	Arhö
aol	alor	Alor
aom	ömie	Ömie
aon	bumbita arapesh	Bumbita Arapesh
aor	aore	Aore
aos	taikat	Taikat
aot	atong (india)	Atong (India)
aou	a'ou	A'Ou
aox	atorada	Atorada
aoz	uab meto	Uab Meto
apa	apaches, langues	Apaches, Langues
apb	sa'a	Sa'A
apc	north levantine arabic	North Levantine Arabic
apd	sudanese arabic	Sudanese Arabic
ape	bukiyip	Bukiyip
apf	pahanan agta	Pahanan Agta
apg	ampanang	Ampanang
aph	athpariya	Athpariya
api	apiaká	Apiaká
apj	jicarilla apache	Jicarilla Apache
apk	kiowa apache	Kiowa Apache
apl	lipan apache	Lipan Apache
apm	mescalero-chiricahua apache	Mescalero-Chiricahua Apache
apn	apinayé	Apinayé
apo	ambul	Ambul
app	apma	Apma
apq	a-pucikwar	A-Pucikwar
apr	arop-lokep	Arop-Lokep
aps	arop-sissano	Arop-Sissano
apt	apatani	Apatani
apu	apurină	Apurină
apv	alapmunte	Alapmunte
apw	western apache	Western Apache
apx	aputai	Aputai
apy	apalaí	Apalaí
apz	safeyoka	Safeyoka
aqc	archi	Archi
aqd	ampari dogon	Ampari Dogon
aqg	arigidi	Arigidi
aqk	aninka	Aninka
aqm	atohwaim	Atohwaim
aqn	northern alta	Northern Alta
aqp	atakapa	Atakapa
aqr	arhà	Arhà
aqt	angaité	Angaité
aqz	akuntsu	Akuntsu
ara	arabe	Arabe
arb	standard arabic	Standard Arabic
arc	araméen d'empire (700-300 av J.C.)	Araméen D'Empire (700-300 Av J.C.)
ard	arabana	Arabana
are	western arrarnta	Western Arrarnta
arg	aragonais	Aragonais
arh	arhuaco	Arhuaco
ari	arikara	Arikara
arj	arapaso	Arapaso
ark	arikapú	Arikapú
arl	arabela	Arabela
arn	mapudungun ; mapuce ; mapuche	Mapudungun ; Mapuce ; Mapuche
aro	araona	Araona
arp	arapaho	Arapaho
arq	algerian arabic	Algerian Arabic
arr	karo (brazil)	Karo (Brazil)
ars	najdi arabic	Najdi Arabic
art	langues artificielles	Langues Artificielles
aru	aruá (amazonas state)	Aruá (Amazonas State)
arv	arbore	Arbore
arw	arawak	Arawak
arx	aruá (rodonia state)	Aruá (Rodonia State)
ary	moroccan arabic	Moroccan Arabic
arz	egyptian arabic	Egyptian Arabic
asa	asu (tanzania)	Asu (Tanzania)
asb	assiniboine	Assiniboine
asc	casuarina coast asmat	Casuarina Coast Asmat
ase	american sign language	American Sign Language
asf	auslan	Auslan
asg	cishingini	Cishingini
ash	abishira	Abishira
asi	buruwai	Buruwai
asj	sari	Sari
ask	ashkun	Ashkun
asl	asilulu	Asilulu
asm	assamais	Assamais
asn	xingú asuriní	Xingú Asuriní
aso	dano	Dano
asp	algerian sign language	Algerian Sign Language
asq	austrian sign language	Austrian Sign Language
asr	asuri	Asuri
ass	ipulo	Ipulo
ast	asturien ; bable ; léonais ; asturoléonais	Asturien ; Bable ; Léonais ; Asturoléonais
asu	tocantins asurini	Tocantins Asurini
asv	asoa	Asoa
asw	australian aborigines sign language	Australian Aborigines Sign Language
asx	muratayak	Muratayak
asy	yaosakor asmat	Yaosakor Asmat
asz	as	As
ata	pele-ata	Pele-Ata
atb	zaiwa	Zaiwa
atc	atsahuaca	Atsahuaca
atd	ata manobo	Ata Manobo
ate	atemble	Atemble
atg	ivbie north-okpela-arhe	Ivbie North-Okpela-Arhe
ath	athapascanes, langues	Athapascanes, Langues
ati	attié	Attié
atj	atikamekw	Atikamekw
atk	ati	Ati
atl	mt. iraya agta	Mt. Iraya Agta
atm	ata	Ata
atn	ashtiani	Ashtiani
ato	atong (cameroon)	Atong (Cameroon)
atp	pudtol atta	Pudtol Atta
atq	aralle-tabulahan	Aralle-Tabulahan
atr	waimiri-atroari	Waimiri-Atroari
ats	gros ventre	Gros Ventre
att	pamplona atta	Pamplona Atta
atu	reel	Reel
atv	northern altai	Northern Altai
atw	atsugewi	Atsugewi
atx	arutani	Arutani
aty	aneityum	Aneityum
atz	arta	Arta
aua	asumboa	Asumboa
aub	alugu	Alugu
auc	waorani	Waorani
aud	anuta	Anuta
aug	aguna	Aguna
auh	aushi	Aushi
aui	anuki	Anuki
auj	awjilah	Awjilah
auk	heyo	Heyo
aul	aulua	Aulua
aum	asu (nigeria)	Asu (Nigeria)
aun	molmo one	Molmo One
auo	auyokawa	Auyokawa
aup	makayam	Makayam
auq	anus	Anus
aur	aruek	Aruek
aus	australiennes, langues	Australiennes, Langues
aut	austral (langues australes)	Austral (Langues Australes)
auu	auye	Auye
auv	auvergnat	Auvergnat
auw	awyi	Awyi
aux	aurá	Aurá
auy	awiyaana	Awiyaana
auz	uzbeki arabic	Uzbeki Arabic
ava	avar	Avar
avb	avau	Avau
avd	alviri-vidari	Alviri-Vidari
ave	avestique	Avestique
avi	avikam	Avikam
avk	kotava	Kotava
avl	eastern egyptian bedawi arabic	Eastern Egyptian Bedawi Arabic
avm	angkamuthi	Angkamuthi
avn	avatime	Avatime
avo	agavotaguerra	Agavotaguerra
avs	aushiri	Aushiri
avt	au	Au
avu	avokaya	Avokaya
avv	avá-canoeiro	Avá-Canoeiro
awa	awadhi	Awadhi
awb	awa (papua new guinea)	Awa (Papua New Guinea)
awc	cicipu	Cicipu
awe	awetí	Awetí
awg	anguthimri	Anguthimri
awh	awbono	Awbono
awi	aekyom	Aekyom
awk	awabakal	Awabakal
awm	arawum	Arawum
awn	awngi	Awngi
awo	awak	Awak
awr	awera	Awera
aws	south awyu	South Awyu
awt	araweté	Araweté
awu	central awyu	Central Awyu
awv	jair awyu	Jair Awyu
aww	awun	Awun
awx	awara	Awara
awy	edera awyu	Edera Awyu
axb	abipon	Abipon
axe	ayerrerenge	Ayerrerenge
axg	mato grosso arára	Mato Grosso Arára
axk	yaka (central african republic)	Yaka (Central African Republic)
axl	lower southern aranda	Lower Southern Aranda
axm	middle armenian	Middle Armenian
axx	xaragurè	Xaragurè
aya	awar	Awar
ayb	ayizo gbe	Ayizo Gbe
ayc	southern aymara	Southern Aymara
ayd	ayabadhu	Ayabadhu
aye	ayere	Ayere
ayg	ginyanga	Ginyanga
ayh	hadrami arabic	Hadrami Arabic
ayi	leyigha	Leyigha
ayk	akuku	Akuku
ayl	libyan arabic	Libyan Arabic
aym	aymara	Aymara
ayn	sanaani arabic	Sanaani Arabic
ayo	ayoreo	Ayoreo
ayp	north mesopotamian arabic	North Mesopotamian Arabic
ayq	ayi (papua new guinea)	Ayi (Papua New Guinea)
ayr	central aymara	Central Aymara
ays	sorsogon ayta	Sorsogon Ayta
ayt	magbukun ayta	Magbukun Ayta
ayu	ayu	Ayu
ayz	mai brat	Mai Brat
aza	azha	Azha
azb	south azerbaijani	South Azerbaijani
azd	eastern durango nahuatl	Eastern Durango Nahuatl
aze	azéri	Azéri
azg	san pedro amuzgos amuzgo	San Pedro Amuzgos Amuzgo
azj	north azerbaijani	North Azerbaijani
azm	ipalapa amuzgo	Ipalapa Amuzgo
azn	western durango nahuatl	Western Durango Nahuatl
azo	awing	Awing
azt	faire atta	Faire Atta
azz	highland puebla nahuatl	Highland Puebla Nahuatl
baa	babatana	Babatana
bab	bainouk-gunyuńo	Bainouk-Gunyuńo
bac	badui	Badui
bad	banda, langues	Banda, Langues
bae	baré	Baré
baf	nubaca	Nubaca
bag	tuki	Tuki
bah	bahamas creole english	Bahamas Creole English
bai	bamiléké, langues	Bamiléké, Langues
baj	barakai	Barakai
bak	bachkir	Bachkir
bal	baloutchi	Baloutchi
bam	bambara	Bambara
ban	balinais	Balinais
bao	waimaha	Waimaha
bap	bantawa	Bantawa
bar	bavarian	Bavarian
bas	basa	Basa
bat	baltes, langues	Baltes, Langues
bau	bada (nigeria)	Bada (Nigeria)
bav	vengo	Vengo
baw	bambili-bambui	Bambili-Bambui
bax	bamun	Bamun
bay	batuley	Batuley
bba	baatonum	Baatonum
bbb	barai	Barai
bbc	batak toba	Batak Toba
bbd	bau	Bau
bbe	bangba	Bangba
bbf	baibai	Baibai
bbg	barama	Barama
bbh	bugan	Bugan
bbi	barombi	Barombi
bbj	ghomálá'	Ghomálá'
bbk	babanki	Babanki
bbl	bats	Bats
bbm	babango	Babango
bbn	uneapa	Uneapa
bbo	northern bobo madaré	Northern Bobo Madaré
bbp	west central banda	West Central Banda
bbq	bamali	Bamali
bbr	girawa	Girawa
bbs	bakpinka	Bakpinka
bbt	mburku	Mburku
bbu	kulung (nigeria)	Kulung (Nigeria)
bbv	karnai	Karnai
bbw	baba	Baba
bbx	bubia	Bubia
bby	befang	Befang
bca	central bai	Central Bai
bcb	bainouk-samik	Bainouk-Samik
bcc	southern balochi	Southern Balochi
bcd	north babar	North Babar
bce	bamenyam	Bamenyam
bcf	bamu	Bamu
bcg	baga pokur	Baga Pokur
bch	bariai	Bariai
bci	baoulé	Baoulé
bcj	bardi	Bardi
bck	bunuba	Bunuba
bcl	central bikol	Central Bikol
bcm	bannoni	Bannoni
bcn	bali (nigeria)	Bali (Nigeria)
bco	kaluli	Kaluli
bcp	bali (democratic republic of congo)	Bali (Democratic Republic Of Congo)
bcq	bench	Bench
bcr	babine	Babine
bcs	kohumono	Kohumono
bct	bendi	Bendi
bcu	awad bing	Awad Bing
bcv	shoo-minda-nye	Shoo-Minda-Nye
bcw	bana	Bana
bcy	bacama	Bacama
bcz	bainouk-gunyaamolo	Bainouk-Gunyaamolo
bda	bayot	Bayot
bdb	basap	Basap
bdc	emberá-baudó	Emberá-Baudó
bdd	bunama	Bunama
bde	bade	Bade
bdf	biage	Biage
bdg	bonggi	Bonggi
bdh	baka (south sudan)	Baka (South Sudan)
bdi	burun	Burun
bdj	bai (south sudan)	Bai (South Sudan)
bdk	budukh	Budukh
bdl	indonesian bajau	Indonesian Bajau
bdm	buduma	Buduma
bdn	baldemu	Baldemu
bdo	morom	Morom
bdp	bende	Bende
bdq	bahnar	Bahnar
bdr	west coast bajau	West Coast Bajau
bds	burunge	Burunge
bdt	bokoto	Bokoto
bdu	oroko	Oroko
bdv	bodo parja	Bodo Parja
bdw	baham	Baham
bdx	budong-budong	Budong-Budong
bdy	bandjalang	Bandjalang
bdz	badeshi	Badeshi
bea	beaver	Beaver
beb	bebele	Bebele
bec	iceve-maci	Iceve-Maci
bed	bedoanas	Bedoanas
bee	byangsi	Byangsi
bef	benabena	Benabena
beg	belait	Belait
beh	biali	Biali
bei	bekati'	Bekati'
bej	bedja	Bedja
bek	bebeli	Bebeli
bel	biélorusse	Biélorusse
bem	bemba	Bemba
ben	bengali	Bengali
beo	beami	Beami
bep	besoa	Besoa
beq	beembe	Beembe
ber	berbères, langues	Berbères, Langues
bes	besme	Besme
bet	guiberoua béte	Guiberoua Béte
beu	blagar	Blagar
bev	daloa bété	Daloa Bété
bew	betawi	Betawi
bex	jur modo	Jur Modo
bey	beli (papua new guinea)	Beli (Papua New Guinea)
bez	bena (tanzania)	Bena (Tanzania)
bfa	bari	Bari
bfb	pauri bareli	Pauri Bareli
bfc	panyi bai	Panyi Bai
bfd	bafut	Bafut
bfe	betaf	Betaf
bff	bofi	Bofi
bfg	busang kayan	Busang Kayan
bfh	blafe	Blafe
bfi	british sign language	British Sign Language
bfj	bafanji	Bafanji
bfk	ban khor sign language	Ban Khor Sign Language
bfl	banda-ndélé	Banda-Ndélé
bfm	mmen	Mmen
bfn	bunak	Bunak
bfo	malba birifor	Malba Birifor
bfp	beba	Beba
bfq	badaga	Badaga
bfr	bazigar	Bazigar
bfs	southern bai	Southern Bai
bft	balti	Balti
bfu	gahri	Gahri
bfw	bondo	Bondo
bfx	bantayanon	Bantayanon
bfy	bagheli	Bagheli
bfz	mahasu pahari	Mahasu Pahari
bga	gwamhi-wuri	Gwamhi-Wuri
bgb	bobongko	Bobongko
bgc	haryanvi	Haryanvi
bgd	rathwi bareli	Rathwi Bareli
bge	bauria	Bauria
bgf	bangandu	Bangandu
bgg	bugun	Bugun
bgi	giangan	Giangan
bgj	bangolan	Bangolan
bgk	bit	Bit
bgl	bo (laos)	Bo (Laos)
bgn	western balochi	Western Balochi
bgo	baga koga	Baga Koga
bgp	eastern balochi	Eastern Balochi
bgq	bagri	Bagri
bgr	bawm chin	Bawm Chin
bgs	tagabawa	Tagabawa
bgt	bughotu	Bughotu
bgu	mbongno	Mbongno
bgv	warkay-bipim	Warkay-Bipim
bgw	bhatri	Bhatri
bgx	balkan gagauz turkish	Balkan Gagauz Turkish
bgy	benggoi	Benggoi
bgz	banggai	Banggai
bha	bharia	Bharia
bhb	bhili	Bhili
bhc	biga	Biga
bhd	bhadrawahi	Bhadrawahi
bhe	bhaya	Bhaya
bhf	odiai	Odiai
bhg	binandere	Binandere
bhh	bukharic	Bukharic
bhi	bhilali	Bhilali
bhj	bahing	Bahing
bhl	bimin	Bimin
bhm	bathari	Bathari
bhn	bohtan neo-aramaic	Bohtan Neo-Aramaic
bho	bhojpuri	Bhojpuri
bhp	bima	Bima
bhq	tukang besi south	Tukang Besi South
bhr	bara malagasy	Bara Malagasy
bhs	buwal	Buwal
bht	bhattiyali	Bhattiyali
bhu	bhunjia	Bhunjia
bhv	bahau	Bahau
bhw	biak	Biak
bhx	bhalay	Bhalay
bhy	bhele	Bhele
bhz	bada (indonesia)	Bada (Indonesia)
bia	badimaya	Badimaya
bib	bissa	Bissa
bid	bidiyo	Bidiyo
bie	bepour	Bepour
bif	biafada	Biafada
big	biangai	Biangai
bih	biharis, langues	Biharis, Langues
bik	bikol	Bikol
bil	bile	Bile
bim	bimoba	Bimoba
bin	bini ; edo	Bini ; Edo
bio	nai	Nai
bip	bila	Bila
biq	bipi	Bipi
bir	bisorio	Bisorio
bis	bichlamar	Bichlamar
bit	berinomo	Berinomo
biu	biete	Biete
biv	southern birifor	Southern Birifor
biw	kol (cameroon)	Kol (Cameroon)
bix	bijori	Bijori
biy	birhor	Birhor
biz	baloi	Baloi
bja	budza	Budza
bjb	banggarla	Banggarla
bjc	bariji	Bariji
bje	biao-jiao mien	Biao-Jiao Mien
bjf	barzani jewish neo-aramaic	Barzani Jewish Neo-Aramaic
bjg	bidyogo	Bidyogo
bjh	bahinemo	Bahinemo
bji	burji	Burji
bjj	kanauji	Kanauji
bjk	barok	Barok
bjl	bulu (papua new guinea)	Bulu (Papua New Guinea)
bjm	bajelani	Bajelani
bjn	banjar	Banjar
bjo	mid-southern banda	Mid-Southern Banda
bjp	fanamaket	Fanamaket
bjr	binumarien	Binumarien
bjs	bajan	Bajan
bjt	balanta-ganja	Balanta-Ganja
bju	busuu	Busuu
bjv	bedjond	Bedjond
bjw	bakwé	Bakwé
bjx	banao itneg	Banao Itneg
bjy	bayali	Bayali
bjz	baruga	Baruga
bka	kyak	Kyak
bkc	baka (cameroon)	Baka (Cameroon)
bkd	binukid	Binukid
bkf	beeke	Beeke
bkg	buraka	Buraka
bkh	bakoko	Bakoko
bki	baki	Baki
bkj	pande	Pande
bkk	brokskat	Brokskat
bkl	berik	Berik
bkm	kom (cameroon)	Kom (Cameroon)
bkn	bukitan	Bukitan
bko	kwa'	Kwa'
bkp	boko (democratic republic of congo)	Boko (Democratic Republic Of Congo)
bkq	bakairí	Bakairí
bkr	bakumpai	Bakumpai
bks	northern sorsoganon	Northern Sorsoganon
bkt	boloki	Boloki
bku	buhid	Buhid
bkv	bekwarra	Bekwarra
bkw	bekwel	Bekwel
bkx	baikeno	Baikeno
bky	bokyi	Bokyi
bkz	bungku	Bungku
bla	blackfoot	Blackfoot
blb	bilua	Bilua
blc	bella coola	Bella Coola
bld	bolango	Bolango
ble	balanta-kentohe	Balanta-Kentohe
blf	buol	Buol
blh	kuwaa	Kuwaa
bli	bolia	Bolia
blj	bolongan	Bolongan
blk	pa'o karen	Pa'O Karen
bll	biloxi	Biloxi
blm	beli (south sudan)	Beli (South Sudan)
bln	southern catanduanes bikol	Southern Catanduanes Bikol
blo	anii	Anii
blp	blablanga	Blablanga
blq	baluan-pam	Baluan-Pam
blr	blang	Blang
bls	balaesang	Balaesang
blt	tai dam	Tai Dam
blv	kibala	Kibala
blw	balangao	Balangao
blx	mag-indi ayta	Mag-Indi Ayta
bly	notre	Notre
blz	balantak	Balantak
bma	lame	Lame
bmb	bembe	Bembe
bmc	biem	Biem
bmd	baga manduri	Baga Manduri
bme	limassa	Limassa
bmf	bom-kim	Bom-Kim
bmg	bamwe	Bamwe
bmh	kein	Kein
bmi	bagirmi	Bagirmi
bmj	bote-majhi	Bote-Majhi
bmk	ghayavi	Ghayavi
bml	bomboli	Bomboli
bmm	northern betsimisaraka malagasy	Northern Betsimisaraka Malagasy
bmn	bina (papua new guinea)	Bina (Papua New Guinea)
bmo	bambalang	Bambalang
bmp	bulgebi	Bulgebi
bmq	bomu	Bomu
bmr	muinane	Muinane
bms	bilma kanuri	Bilma Kanuri
bmt	biao mon	Biao Mon
bmu	somba-siawari	Somba-Siawari
bmv	bum	Bum
bmw	bomwali	Bomwali
bmx	baimak	Baimak
bmz	baramu	Baramu
bna	bonerate	Bonerate
bnb	bookan	Bookan
bnc	bontok	Bontok
bnd	banda (indonesia)	Banda (Indonesia)
bne	bintauna	Bintauna
bnf	masiwang	Masiwang
bng	benga	Benga
bni	bangi	Bangi
bnj	eastern tawbuid	Eastern Tawbuid
bnk	bierebo	Bierebo
bnl	boon	Boon
bnm	batanga	Batanga
bnn	bunun	Bunun
bno	bantoanon	Bantoanon
bnp	bola	Bola
bnq	bantik	Bantik
bnr	butmas-tur	Butmas-Tur
bns	bundeli	Bundeli
bnt	bantou, langues	Bantou, Langues
bnu	bentong	Bentong
bnv	bonerif	Bonerif
bnw	bisis	Bisis
bnx	bangubangu	Bangubangu
bny	bintulu	Bintulu
bnz	beezen	Beezen
boa	bora	Bora
bob	aweer	Aweer
bod	tibétain	Tibétain
boe	mundabli	Mundabli
bof	bolon	Bolon
bog	bamako sign language	Bamako Sign Language
boh	boma	Boma
boi	barbareńo	Barbareńo
boj	anjam	Anjam
bok	bonjo	Bonjo
bol	bole	Bole
bom	berom	Berom
bon	bine	Bine
boo	tiemacčwč bozo	Tiemacčwč Bozo
bop	bonkiman	Bonkiman
boq	bogaya	Bogaya
bor	borôro	Borôro
bos	bosniaque	Bosniaque
bot	bongo	Bongo
bou	bondei	Bondei
bov	tuwuli	Tuwuli
bow	rema	Rema
box	buamu	Buamu
boy	bodo (central african republic)	Bodo (Central African Republic)
boz	tiéyaxo bozo	Tiéyaxo Bozo
bpa	daakaka	Daakaka
bpc	mbuk	Mbuk
bpd	banda-banda	Banda-Banda
bpe	bauni	Bauni
bpg	bonggo	Bonggo
bph	botlikh	Botlikh
bpi	bagupi	Bagupi
bpj	binji	Binji
bpk	ôrôè	Ôrôè
bpl	broome pearling lugger pidgin	Broome Pearling Lugger Pidgin
bpm	biyom	Biyom
bpn	dzao min	Dzao Min
bpo	anasi	Anasi
bpp	kaure	Kaure
bpq	banda malay	Banda Malay
bpr	koronadal blaan	Koronadal Blaan
bps	sarangani blaan	Sarangani Blaan
bpt	barrow point	Barrow Point
bpu	bongu	Bongu
bpv	bian marind	Bian Marind
bpw	bo (papua new guinea)	Bo (Papua New Guinea)
bpx	palya bareli	Palya Bareli
bpy	bishnupriya	Bishnupriya
bpz	bilba	Bilba
bqa	tchumbuli	Tchumbuli
bqb	bagusa	Bagusa
bqc	boko (benin)	Boko (Benin)
bqd	bung	Bung
bqf	baga kaloum	Baga Kaloum
bqg	bago-kusuntu	Bago-Kusuntu
bqh	baima	Baima
bqi	bakhtiari	Bakhtiari
bqj	bandial	Bandial
bqk	banda-mbrčs	Banda-Mbrčs
bql	bilakura	Bilakura
bqm	wumboko	Wumboko
bqn	bulgarian sign language	Bulgarian Sign Language
bqo	balo	Balo
bqp	busa	Busa
bqq	biritai	Biritai
bqr	burusu	Burusu
bqs	bosngun	Bosngun
bqt	bamukumbit	Bamukumbit
bqu	boguru	Boguru
bqv	koro wachi	Koro Wachi
bqw	buru (nigeria)	Buru (Nigeria)
bqx	baangi	Baangi
bqy	bengkala sign language	Bengkala Sign Language
bqz	bakaka	Bakaka
bra	braj	Braj
brb	brao	Brao
brc	berbice creole dutch	Berbice Creole Dutch
brd	baraamu	Baraamu
bre	breton	Breton
brf	bira	Bira
brg	baure	Baure
brh	brahui	Brahui
bri	mokpwe	Mokpwe
brj	bieria	Bieria
brk	birked	Birked
brl	birwa	Birwa
brm	barambu	Barambu
brn	boruca	Boruca
bro	brokkat	Brokkat
brp	barapasi	Barapasi
brq	breri	Breri
brr	birao	Birao
brs	baras	Baras
brt	bitare	Bitare
bru	eastern bru	Eastern Bru
brv	western bru	Western Bru
brw	bellari	Bellari
brx	bodo (india)	Bodo (India)
bry	burui	Burui
brz	bilbil	Bilbil
bsa	abinomn	Abinomn
bsb	brunei bisaya	Brunei Bisaya
bsc	bassari	Bassari
bse	wushi	Wushi
bsf	bauchi	Bauchi
bsg	bashkardi	Bashkardi
bsh	kati	Kati
bsi	bassossi	Bassossi
bsj	bangwinji	Bangwinji
bsk	burushaski	Burushaski
bsl	basa-gumna	Basa-Gumna
bsm	busami	Busami
bsn	barasana-eduria	Barasana-Eduria
bso	buso	Buso
bsp	baga sitemu	Baga Sitemu
bsq	bassa	Bassa
bsr	bassa-kontagora	Bassa-Kontagora
bss	akoose	Akoose
bst	basketo	Basketo
bsu	bahonsuai	Bahonsuai
bsv	baga sobané	Baga Sobané
bsw	baiso	Baiso
bsx	yangkam	Yangkam
bsy	sabah bisaya	Sabah Bisaya
bta	bata	Bata
btc	bati (cameroon)	Bati (Cameroon)
btd	batak dairi	Batak Dairi
bte	gamo-ningi	Gamo-Ningi
btf	birgit	Birgit
btg	gagnoa bété	Gagnoa Bété
bth	biatah bidayuh	Biatah Bidayuh
bti	burate	Burate
btj	bacanese malay	Bacanese Malay
btk	batak, langues	Batak, Langues
btm	batak mandailing	Batak Mandailing
btn	ratagnon	Ratagnon
bto	rinconada bikol	Rinconada Bikol
btp	budibud	Budibud
btq	batek	Batek
btr	baetora	Baetora
bts	batak simalungun	Batak Simalungun
btt	bete-bendi	Bete-Bendi
btu	batu	Batu
btv	bateri	Bateri
btw	butuanon	Butuanon
btx	batak karo	Batak Karo
bty	bobot	Bobot
btz	batak alas-kluet	Batak Alas-Kluet
bua	bouriate	Bouriate
bub	bua	Bua
buc	shibushi	Shibushi
bud	ntcham	Ntcham
bue	beothuk	Beothuk
buf	bushoong	Bushoong
bug	bugi	Bugi
buh	younuo bunu	Younuo Bunu
bui	bongili	Bongili
buj	basa-gurmana	Basa-Gurmana
buk	bugawac	Bugawac
bul	bulgare	Bulgare
bum	bulu (cameroon)	Bulu (Cameroon)
bun	sherbro	Sherbro
buo	terei	Terei
bup	busoa	Busoa
buq	brem	Brem
bus	bokobaru	Bokobaru
but	bungain	Bungain
buu	budu	Budu
buv	bun	Bun
buw	bubi	Bubi
bux	boghom	Boghom
buy	bullom so	Bullom So
buz	bukwen	Bukwen
bva	barein	Barein
bvb	bube	Bube
bvc	baelelea	Baelelea
bvd	baeggu	Baeggu
bve	berau malay	Berau Malay
bvf	boor	Boor
bvg	bonkeng	Bonkeng
bvh	bure	Bure
bvi	belanda viri	Belanda Viri
bvj	baan	Baan
bvk	bukat	Bukat
bvl	bolivian sign language	Bolivian Sign Language
bvm	bamunka	Bamunka
bvn	buna	Buna
bvo	bolgo	Bolgo
bvp	bumang	Bumang
bvq	birri	Birri
bvr	burarra	Burarra
bvt	bati (indonesia)	Bati (Indonesia)
bvu	bukit malay	Bukit Malay
bvv	baniva	Baniva
bvw	boga	Boga
bvx	dibole	Dibole
bvy	baybayanon	Baybayanon
bvz	bauzi	Bauzi
bwa	bwatoo	Bwatoo
bwb	namosi-naitasiri-serua	Namosi-Naitasiri-Serua
bwc	bwile	Bwile
bwd	bwaidoka	Bwaidoka
bwe	bwe karen	Bwe Karen
bwf	boselewa	Boselewa
bwg	barwe	Barwe
bwh	bishuo	Bishuo
bwi	baniwa	Baniwa
bwj	láá láá bwamu	Láá Láá Bwamu
bwk	bauwaki	Bauwaki
bwl	bwela	Bwela
bwm	biwat	Biwat
bwn	wunai bunu	Wunai Bunu
bwo	boro (ethiopia)	Boro (Ethiopia)
bwp	mandobo bawah	Mandobo Bawah
bwq	southern bobo madaré	Southern Bobo Madaré
bwr	bura-pabir	Bura-Pabir
bws	bomboma	Bomboma
bwt	bafaw-balong	Bafaw-Balong
bwu	buli (ghana)	Buli (Ghana)
bww	bwa	Bwa
bwx	bu-nao bunu	Bu-Nao Bunu
bwy	cwi bwamu	Cwi Bwamu
bwz	bwisi	Bwisi
bxa	tairaha	Tairaha
bxb	belanda bor	Belanda Bor
bxc	molengue	Molengue
bxd	pela	Pela
bxe	birale	Birale
bxf	bilur	Bilur
bxg	bangala	Bangala
bxh	buhutu	Buhutu
bxi	pirlatapa	Pirlatapa
bxj	bayungu	Bayungu
bxk	bukusu	Bukusu
bxl	jalkunan	Jalkunan
bxm	mongolia buriat	Mongolia Buriat
bxn	burduna	Burduna
bxo	barikanchi	Barikanchi
bxp	bebil	Bebil
bxq	beele	Beele
bxr	russia buriat	Russia Buriat
bxs	busam	Busam
bxu	china buriat	China Buriat
bxv	berakou	Berakou
bxw	bankagooma	Bankagooma
bxz	binahari	Binahari
bya	batak	Batak
byb	bikya	Bikya
byc	ubaghara	Ubaghara
byd	benyadu'	Benyadu'
bye	pouye	Pouye
byf	bete	Bete
byg	baygo	Baygo
byh	bhujel	Bhujel
byi	buyu	Buyu
byj	bina (nigeria)	Bina (Nigeria)
byk	biao	Biao
byl	bayono	Bayono
bym	bidjara	Bidjara
byn	bilen ; blin	Bilen ; Blin
byo	biyo	Biyo
byp	bumaji	Bumaji
byq	basay	Basay
byr	baruya	Baruya
bys	burak	Burak
byt	berti	Berti
byv	medumba	Medumba
byw	belhariya	Belhariya
byx	qaqet	Qaqet
byz	banaro	Banaro
bza	bandi	Bandi
bzb	andio	Andio
bzc	southern betsimisaraka malagasy	Southern Betsimisaraka Malagasy
bzd	bribri	Bribri
bze	jenaama bozo	Jenaama Bozo
bzf	boikin	Boikin
bzg	babuza	Babuza
bzh	mapos buang	Mapos Buang
bzi	bisu	Bisu
bzj	belize kriol english	Belize Kriol English
bzk	nicaragua creole english	Nicaragua Creole English
bzl	boano (sulawesi)	Boano (Sulawesi)
bzm	bolondo	Bolondo
bzn	boano (maluku)	Boano (Maluku)
bzo	bozaba	Bozaba
bzp	kemberano	Kemberano
bzq	buli (indonesia)	Buli (Indonesia)
bzr	biri	Biri
bzs	brazilian sign language	Brazilian Sign Language
bzt	brithenig	Brithenig
bzu	burmeso	Burmeso
bzv	naami	Naami
bzw	basa (nigeria)	Basa (Nigeria)
bzx	kelengaxo bozo	Kelengaxo Bozo
bzy	obanliku	Obanliku
bzz	evant	Evant
caa	chortí	Chortí
cab	garifuna	Garifuna
cac	chuj	Chuj
cad	caddo	Caddo
cae	lehar	Lehar
caf	southern carrier	Southern Carrier
cag	nivaclé	Nivaclé
cah	cahuarano	Cahuarano
cai	amérindiennes d'Amérique centrale, langues	Amérindiennes D'Amérique Centrale, Langues
caj	chané	Chané
cak	kaqchikel	Kaqchikel
cal	carolinian	Carolinian
cam	cèmuhi	Cèmuhi
can	chambri	Chambri
cao	chácobo	Chácobo
cap	chipaya	Chipaya
caq	car nicobarese	Car Nicobarese
car	karib ; galibi ; carib	Karib ; Galibi ; Carib
cas	tsimané	Tsimané
cat	catalan ; valencien	Catalan ; Valencien
cau	caucasiennes, langues	Caucasiennes, Langues
cav	cavineńa	Cavineńa
caw	callawalla	Callawalla
cax	chiquitano	Chiquitano
cay	cayuga	Cayuga
caz	canichana	Canichana
cbb	cabiyarí	Cabiyarí
cbc	carapana	Carapana
cbd	carijona	Carijona
cbg	chimila	Chimila
cbi	chachi	Chachi
cbj	ede cabe	Ede Cabe
cbk	chavacano	Chavacano
cbl	bualkhaw chin	Bualkhaw Chin
cbn	nyahkur	Nyahkur
cbo	izora	Izora
cbq	tsucuba	Tsucuba
cbr	cashibo-cacataibo	Cashibo-Cacataibo
cbs	cashinahua	Cashinahua
cbt	chayahuita	Chayahuita
cbu	candoshi-shapra	Candoshi-Shapra
cbv	cacua	Cacua
cbw	kinabalian	Kinabalian
cby	carabayo	Carabayo
ccc	chamicuro	Chamicuro
ccd	cafundo creole	Cafundo Creole
cce	chopi	Chopi
ccg	samba daka	Samba Daka
cch	atsam	Atsam
ccj	kasanga	Kasanga
ccl	cutchi-swahili	Cutchi-Swahili
ccm	malaccan creole malay	Malaccan Creole Malay
cco	comaltepec chinantec	Comaltepec Chinantec
ccp	chakma	Chakma
ccr	cacaopera	Cacaopera
cda	choni	Choni
cde	chenchu	Chenchu
cdf	chiru	Chiru
cdh	chambeali	Chambeali
cdi	chodri	Chodri
cdj	churahi	Churahi
cdm	chepang	Chepang
cdn	chaudangsi	Chaudangsi
cdo	min dong chinese	Min Dong Chinese
cdr	cinda-regi-tiyal	Cinda-Regi-Tiyal
cds	chadian sign language	Chadian Sign Language
cdy	chadong	Chadong
cdz	koda	Koda
cea	lower chehalis	Lower Chehalis
ceb	cebuano	Cebuano
ceg	chamacoco	Chamacoco
cek	eastern khumi chin	Eastern Khumi Chin
cel	celtiques, langues ; celtes, langues	Celtiques, Langues ; Celtes, Langues
cen	cen	Cen
ces	tchèque	Tchèque
cet	centúúm	Centúúm
cey	ekai chin	Ekai Chin
cfa	dijim-bwilim	Dijim-Bwilim
cfd	cara	Cara
cfg	como karim	Como Karim
cfm	falam chin	Falam Chin
cga	changriwa	Changriwa
cgc	kagayanen	Kagayanen
cgg	chiga	Chiga
cgk	chocangacakha	Chocangacakha
cha	chamorro	Chamorro
chb	chibcha	Chibcha
chc	catawba	Catawba
chd	highland oaxaca chontal	Highland Oaxaca Chontal
che	tchétchène	Tchétchène
chf	tabasco chontal	Tabasco Chontal
chg	djaghataï	Djaghataï
chh	chinook	Chinook
chj	ojitlán chinantec	Ojitlán Chinantec
chk	chuuk	Chuuk
chl	cahuilla	Cahuilla
chm	mari	Mari
chn	chinook, jargon	Chinook, Jargon
cho	choctaw	Choctaw
chp	chipewyan	Chipewyan
chq	quiotepec chinantec	Quiotepec Chinantec
chr	cherokee	Cherokee
cht	cholón	Cholón
chu	slavon d'église ; vieux slave ; slavon liturgique ; vieux bulgare	Slavon D'Église ; Vieux Slave ; Slavon Liturgique ; Vieux Bulgare
chv	tchouvache	Tchouvache
chw	chuwabu	Chuwabu
chx	chantyal	Chantyal
chy	cheyenne	Cheyenne
chz	ozumacín chinantec	Ozumacín Chinantec
cia	cia-cia	Cia-Cia
cib	ci gbe	Ci Gbe
cic	chickasaw	Chickasaw
cid	chimariko	Chimariko
cie	cineni	Cineni
cih	chinali	Chinali
cik	chitkuli kinnauri	Chitkuli Kinnauri
cim	cimbrian	Cimbrian
cin	cinta larga	Cinta Larga
cip	chiapanec	Chiapanec
cir	tîrî	Tîrî
ciw	chippewa	Chippewa
ciy	chaima	Chaima
cja	western cham	Western Cham
cje	chru	Chru
cjh	upper chehalis	Upper Chehalis
cji	chamalal	Chamalal
cjk	chokwe	Chokwe
cjm	eastern cham	Eastern Cham
cjn	chenapian	Chenapian
cjo	ashéninka pajonal	Ashéninka Pajonal
cjp	cabécar	Cabécar
cjs	shor	Shor
cjv	chuave	Chuave
cjy	jinyu chinese	Jinyu Chinese
ckb	central kurdish	Central Kurdish
ckh	chak	Chak
ckl	cibak	Cibak
ckm	chakavian	Chakavian
ckn	kaang chin	Kaang Chin
cko	anufo	Anufo
ckq	kajakse	Kajakse
ckr	kairak	Kairak
cks	tayo	Tayo
ckt	chukot	Chukot
cku	koasati	Koasati
ckv	kavalan	Kavalan
ckx	caka	Caka
cky	cakfem-mushere	Cakfem-Mushere
ckz	cakchiquel-quiché mixed language	Cakchiquel-Quiché Mixed Language
cla	ron	Ron
clc	chilcotin	Chilcotin
cld	chaldean neo-aramaic	Chaldean Neo-Aramaic
cle	lealao chinantec	Lealao Chinantec
clh	chilisso	Chilisso
cli	chakali	Chakali
clj	laitu chin	Laitu Chin
clk	idu-mishmi	Idu-Mishmi
cll	chala	Chala
clm	clallam	Clallam
clo	lowland oaxaca chontal	Lowland Oaxaca Chontal
clt	lautu chin	Lautu Chin
clu	caluyanun	Caluyanun
clw	chulym	Chulym
cly	eastern highland chatino	Eastern Highland Chatino
cma	maa	Maa
cmc	chames, langues	Chames, Langues
cme	cerma	Cerma
cmg	classical mongolian	Classical Mongolian
cmi	emberá-chamí	Emberá-Chamí
cml	campalagian	Campalagian
cmm	michigamea	Michigamea
cmn	mandarin chinese	Mandarin Chinese
cmo	central mnong	Central Mnong
cmr	mro-khimi chin	Mro-Khimi Chin
cms	messapic	Messapic
cmt	camtho	Camtho
cna	changthang	Changthang
cnb	chinbon chin	Chinbon Chin
cnc	côông	Côông
cng	northern qiang	Northern Qiang
cnh	hakha chin	Hakha Chin
cni	asháninka	Asháninka
cnk	khumi chin	Khumi Chin
cnl	lalana chinantec	Lalana Chinantec
cno	con	Con
cnp	northern ping chinese	Northern Ping Chinese
cnq	chung	Chung
cnr	monténégrin	Monténégrin
cns	central asmat	Central Asmat
cnt	tepetotutla chinantec	Tepetotutla Chinantec
cnu	chenoua	Chenoua
cnw	ngawn chin	Ngawn Chin
cnx	middle cornish	Middle Cornish
coa	cocos islands malay	Cocos Islands Malay
cob	chicomuceltec	Chicomuceltec
coc	cocopa	Cocopa
cod	cocama-cocamilla	Cocama-Cocamilla
coe	koreguaje	Koreguaje
cof	colorado	Colorado
cog	chong	Chong
coh	chonyi-dzihana-kauma	Chonyi-Dzihana-Kauma
coj	cochimi	Cochimi
cok	santa teresa cora	Santa Teresa Cora
col	columbia-wenatchi	Columbia-Wenatchi
com	comanche	Comanche
con	cofán	Cofán
coo	comox	Comox
cop	copte	Copte
coq	coquille	Coquille
cor	cornique	Cornique
cos	corse	Corse
cot	caquinte	Caquinte
cou	wamey	Wamey
cov	cao miao	Cao Miao
cow	cowlitz	Cowlitz
cox	nanti	Nanti
coz	chochotec	Chochotec
cpa	palantla chinantec	Palantla Chinantec
cpb	ucayali-yurúa ashéninka	Ucayali-Yurúa Ashéninka
cpc	ajyíninka apurucayali	Ajyíninka Apurucayali
cpe	créoles et pidgins basés sur l'anglais	Créoles Et Pidgins Basés Sur L'Anglais
cpf	créoles et pidgins basés sur le français	Créoles Et Pidgins Basés Sur Le Français
cpg	cappadocian greek	Cappadocian Greek
cpi	chinese pidgin english	Chinese Pidgin English
cpn	cherepon	Cherepon
cpo	kpeego	Kpeego
cpp	créoles et pidgins basés sur le portugais	Créoles Et Pidgins Basés Sur Le Portugais
cps	capiznon	Capiznon
cpu	pichis ashéninka	Pichis Ashéninka
cpx	pu-xian chinese	Pu-Xian Chinese
cpy	south ucayali ashéninka	South Ucayali Ashéninka
cqd	chuanqiandian cluster miao	Chuanqiandian Cluster Miao
cra	chara	Chara
crb	island carib	Island Carib
crc	lonwolwol	Lonwolwol
crd	coeur d'alene	Coeur D'Alene
cre	cree	Cree
crf	caramanta	Caramanta
crg	michif	Michif
crh	tatar de Crimé	Tatar De Crimé
cri	săotomense	Săotomense
crj	southern east cree	Southern East Cree
crk	plains cree	Plains Cree
crl	northern east cree	Northern East Cree
crm	moose cree	Moose Cree
crn	el nayar cora	El Nayar Cora
cro	crow	Crow
crp	créoles et pidgins	Créoles Et Pidgins
crq	iyo'wujwa chorote	Iyo'Wujwa Chorote
crr	carolina algonquian	Carolina Algonquian
crs	seselwa creole french	Seselwa Creole French
crt	iyojwa'ja chorote	Iyojwa'Ja Chorote
crv	chaura	Chaura
crw	chrau	Chrau
crx	carrier	Carrier
cry	cori	Cori
crz	cruzeńo	Cruzeńo
csa	chiltepec chinantec	Chiltepec Chinantec
csb	kachoube	Kachoube
csc	catalan sign language	Catalan Sign Language
csd	chiangmai sign language	Chiangmai Sign Language
cse	czech sign language	Czech Sign Language
csf	cuba sign language	Cuba Sign Language
csg	chilean sign language	Chilean Sign Language
csh	asho chin	Asho Chin
csi	coast miwok	Coast Miwok
csj	songlai chin	Songlai Chin
csk	jola-kasa	Jola-Kasa
csl	chinese sign language	Chinese Sign Language
csm	central sierra miwok	Central Sierra Miwok
csn	colombian sign language	Colombian Sign Language
cso	sochiapam chinantec	Sochiapam Chinantec
csp	southern ping chinese	Southern Ping Chinese
csq	croatia sign language	Croatia Sign Language
csr	costa rican sign language	Costa Rican Sign Language
css	southern ohlone	Southern Ohlone
cst	northern ohlone	Northern Ohlone
csv	sumtu chin	Sumtu Chin
csw	swampy cree	Swampy Cree
csx	cambodian sign language	Cambodian Sign Language
csy	siyin chin	Siyin Chin
csz	coos	Coos
cta	tataltepec chatino	Tataltepec Chatino
ctc	chetco	Chetco
ctd	tedim chin	Tedim Chin
cte	tepinapa chinantec	Tepinapa Chinantec
ctg	chittagonian	Chittagonian
cth	thaiphum chin	Thaiphum Chin
ctl	tlacoatzintepec chinantec	Tlacoatzintepec Chinantec
ctm	chitimacha	Chitimacha
ctn	chhintange	Chhintange
cto	emberá-catío	Emberá-Catío
ctp	western highland chatino	Western Highland Chatino
cts	northern catanduanes bikol	Northern Catanduanes Bikol
ctt	wayanad chetti	Wayanad Chetti
ctu	chol	Chol
cty	moundadan chetty	Moundadan Chetty
ctz	zacatepec chatino	Zacatepec Chatino
cua	cua	Cua
cub	cubeo	Cubeo
cuc	usila chinantec	Usila Chinantec
cuh	chuka	Chuka
cui	cuiba	Cuiba
cuj	mashco piro	Mashco Piro
cuk	san blas kuna	San Blas Kuna
cul	culina	Culina
cuo	cumanagoto	Cumanagoto
cup	cupeńo	Cupeńo
cuq	cun	Cun
cur	chhulung	Chhulung
cus	couchitiques, langues	Couchitiques, Langues
cut	teutila cuicatec	Teutila Cuicatec
cuu	tai ya	Tai Ya
cuv	cuvok	Cuvok
cuw	chukwa	Chukwa
cux	tepeuxila cuicatec	Tepeuxila Cuicatec
cuy	cuitlatec	Cuitlatec
cvg	chug	Chug
cvn	valle nacional chinantec	Valle Nacional Chinantec
cwa	kabwa	Kabwa
cwb	maindo	Maindo
cwd	woods cree	Woods Cree
cwe	kwere	Kwere
cwg	chewong	Chewong
cwt	kuwaataay	Kuwaataay
cya	nopala chatino	Nopala Chatino
cyb	cayubaba	Cayubaba
cym	gallois	Gallois
cyo	cuyonon	Cuyonon
czh	huizhou chinese	Huizhou Chinese
czk	knaanic	Knaanic
czn	zenzontepec chatino	Zenzontepec Chatino
czo	min zhong chinese	Min Zhong Chinese
czt	zotung chin	Zotung Chin
daa	dangaléat	Dangaléat
dac	dambi	Dambi
dad	marik	Marik
dae	duupa	Duupa
dag	dagbani	Dagbani
dah	gwahatike	Gwahatike
dai	day	Day
daj	dar fur daju	Dar Fur Daju
dak	dakota	Dakota
dal	dahalo	Dahalo
dam	damakawa	Damakawa
dan	danois	Danois
dao	daai chin	Daai Chin
daq	dandami maria	Dandami Maria
dar	dargwa	Dargwa
das	daho-doo	Daho-Doo
dau	dar sila daju	Dar Sila Daju
dav	taita	Taita
daw	davawenyo	Davawenyo
dax	dayi	Dayi
day	dayak, langues	Dayak, Langues
daz	dao	Dao
dba	bangime	Bangime
dbb	deno	Deno
dbd	dadiya	Dadiya
dbe	dabe	Dabe
dbf	edopi	Edopi
dbg	dogul dom dogon	Dogul Dom Dogon
dbi	doka	Doka
dbj	ida'an	Ida'An
dbl	dyirbal	Dyirbal
dbm	duguri	Duguri
dbn	duriankere	Duriankere
dbo	dulbu	Dulbu
dbp	duwai	Duwai
dbq	daba	Daba
dbr	dabarre	Dabarre
dbt	ben tey dogon	Ben Tey Dogon
dbu	bondum dom dogon	Bondum Dom Dogon
dbv	dungu	Dungu
dbw	bankan tey dogon	Bankan Tey Dogon
dby	dibiyaso	Dibiyaso
dcc	deccan	Deccan
dcr	negerhollands	Negerhollands
dda	dadi dadi	Dadi Dadi
ddd	dongotono	Dongotono
dde	doondo	Doondo
ddg	fataluku	Fataluku
ddi	west goodenough	West Goodenough
ddj	jaru	Jaru
ddn	dendi (benin)	Dendi (Benin)
ddo	dido	Dido
ddr	dhudhuroa	Dhudhuroa
dds	donno so dogon	Donno So Dogon
ddw	dawera-daweloor	Dawera-Daweloor
dec	dagik	Dagik
ded	dedua	Dedua
dee	dewoin	Dewoin
def	dezfuli	Dezfuli
deg	degema	Degema
deh	dehwari	Dehwari
dei	demisa	Demisa
dek	dek	Dek
del	delaware	Delaware
dem	dem	Dem
den	esclave (athapascan)	Esclave (Athapascan)
dep	pidgin delaware	Pidgin Delaware
deq	dendi (central african republic)	Dendi (Central African Republic)
der	deori	Deori
des	desano	Desano
deu	allemand	Allemand
dev	domung	Domung
dez	dengese	Dengese
dga	southern dagaare	Southern Dagaare
dgb	bunoge dogon	Bunoge Dogon
dgc	casiguran dumagat agta	Casiguran Dumagat Agta
dgd	dagaari dioula	Dagaari Dioula
dge	degenan	Degenan
dgg	doga	Doga
dgh	dghwede	Dghwede
dgi	northern dagara	Northern Dagara
dgk	dagba	Dagba
dgl	andaandi	Andaandi
dgn	dagoman	Dagoman
dgo	dogri (individual language)	Dogri (Individual Language)
dgr	dogrib	Dogrib
dgs	dogoso	Dogoso
dgt	ndra'ngith	Ndra'Ngith
dgw	daungwurrung	Daungwurrung
dgx	doghoro	Doghoro
dgz	daga	Daga
dhd	dhundari	Dhundari
dhg	dhangu-djangu	Dhangu-Djangu
dhi	dhimal	Dhimal
dhl	dhalandji	Dhalandji
dhm	zemba	Zemba
dhn	dhanki	Dhanki
dho	dhodia	Dhodia
dhr	dhargari	Dhargari
dhs	dhaiso	Dhaiso
dhu	dhurga	Dhurga
dhv	drehu	Drehu
dhw	dhanwar (nepal)	Dhanwar (Nepal)
dhx	dhungaloo	Dhungaloo
dia	dia	Dia
dib	south central dinka	South Central Dinka
dic	lakota dida	Lakota Dida
did	didinga	Didinga
dif	dieri	Dieri
dig	digo	Digo
dih	kumiai	Kumiai
dii	dimbong	Dimbong
dij	dai	Dai
dik	southwestern dinka	Southwestern Dinka
dil	dilling	Dilling
dim	dime	Dime
din	dinka	Dinka
dio	dibo	Dibo
dip	northeastern dinka	Northeastern Dinka
diq	dimli (individual language)	Dimli (Individual Language)
dir	dirim	Dirim
dis	dimasa	Dimasa
diu	diriku	Diriku
div	maldivien	Maldivien
diw	northwestern dinka	Northwestern Dinka
dix	dixon reef	Dixon Reef
diy	diuwe	Diuwe
diz	ding	Ding
dja	djadjawurrung	Djadjawurrung
djb	djinba	Djinba
djc	dar daju daju	Dar Daju Daju
djd	djamindjung	Djamindjung
dje	zarma	Zarma
djf	djangun	Djangun
dji	djinang	Djinang
djj	djeebbana	Djeebbana
djk	aluku / ndjuka / paramaca	Aluku / Ndjuka / Paramaca
djm	jamsay dogon	Jamsay Dogon
djn	jawoyn	Jawoyn
djo	jangkang	Jangkang
djr	djambarrpuyngu	Djambarrpuyngu
dju	kapriman	Kapriman
djw	djawi	Djawi
dka	dakpakha	Dakpakha
dkg	kadung	Kadung
dkk	dakka	Dakka
dkr	kuijau	Kuijau
dks	southeastern dinka	Southeastern Dinka
dkx	mazagway	Mazagway
dlg	dolgan	Dolgan
dlk	dahalik	Dahalik
dlm	dalmatian	Dalmatian
dln	darlong	Darlong
dma	duma	Duma
dmb	mombo dogon	Mombo Dogon
dmc	gavak	Gavak
dmd	madhi madhi	Madhi Madhi
dme	dugwor	Dugwor
dmf	medefaidrin	Medefaidrin
dmg	upper kinabatangan	Upper Kinabatangan
dmk	domaaki	Domaaki
dml	dameli	Dameli
dmm	dama	Dama
dmo	kemedzung	Kemedzung
dmr	east damar	East Damar
dms	dampelas	Dampelas
dmu	dubu	Dubu
dmv	dumpas	Dumpas
dmw	mudburra	Mudburra
dmx	dema	Dema
dmy	demta	Demta
dna	upper grand valley dani	Upper Grand Valley Dani
dnd	daonda	Daonda
dne	ndendeule	Ndendeule
dng	dungan	Dungan
dni	lower grand valley dani	Lower Grand Valley Dani
dnj	dan	Dan
dnk	dengka	Dengka
dnn	dzůůngoo	Dzůůngoo
dno	ndrulo	Ndrulo
dnr	danaru	Danaru
dnt	mid grand valley dani	Mid Grand Valley Dani
dnu	danau	Danau
dnv	danu	Danu
dnw	western dani	Western Dani
dny	dení	Dení
doa	dom	Dom
dob	dobu	Dobu
doc	northern dong	Northern Dong
doe	doe	Doe
dof	domu	Domu
doh	dong	Dong
doi	dogri	Dogri
dok	dondo	Dondo
dol	doso	Doso
don	toura (papua new guinea)	Toura (Papua New Guinea)
doo	dongo	Dongo
dop	lukpa	Lukpa
doq	dominican sign language	Dominican Sign Language
dor	dori'o	Dori'O
dos	dogosé	Dogosé
dot	dass	Dass
dov	dombe	Dombe
dow	doyayo	Doyayo
dox	bussa	Bussa
doy	dompo	Dompo
doz	dorze	Dorze
dpp	papar	Papar
dra	dravidiennes, langues	Dravidiennes, Langues
drb	dair	Dair
drc	minderico	Minderico
drd	darmiya	Darmiya
dre	dolpo	Dolpo
drg	rungus	Rungus
dri	c'lela	C'Lela
drl	paakantyi	Paakantyi
drn	west damar	West Damar
dro	daro-matu melanau	Daro-Matu Melanau
drq	dura	Dura
drs	gedeo	Gedeo
drt	drents	Drents
dru	rukai	Rukai
dry	darai	Darai
dsb	bas-sorabe	Bas-Sorabe
dse	dutch sign language	Dutch Sign Language
dsh	daasanach	Daasanach
dsi	disa	Disa
dsl	danish sign language	Danish Sign Language
dsn	dusner	Dusner
dso	desiya	Desiya
dsq	tadaksahak	Tadaksahak
dsz	mardin sign language	Mardin Sign Language
dta	daur	Daur
dtb	labuk-kinabatangan kadazan	Labuk-Kinabatangan Kadazan
dtd	ditidaht	Ditidaht
dth	adithinngithigh	Adithinngithigh
dti	ana tinga dogon	Ana Tinga Dogon
dtk	tene kan dogon	Tene Kan Dogon
dtm	tomo kan dogon	Tomo Kan Dogon
dtn	daats'i´in	Daats'I´In
dto	tommo so dogon	Tommo So Dogon
dtp	kadazan dusun	Kadazan Dusun
dtr	lotud	Lotud
dts	toro so dogon	Toro So Dogon
dtt	toro tegu dogon	Toro Tegu Dogon
dtu	tebul ure dogon	Tebul Ure Dogon
dty	dotyali	Dotyali
dua	douala	Douala
dub	dubli	Dubli
duc	duna	Duna
due	umiray dumaget agta	Umiray Dumaget Agta
duf	drubéa	Drubéa
dug	duruma	Duruma
duh	dungra bhil	Dungra Bhil
dui	dumun	Dumun
duk	uyajitaya	Uyajitaya
dul	alabat island agta	Alabat Island Agta
dum	néerlandais moyen (ca. 1050-1350)	Néerlandais Moyen (Ca. 1050-1350)
dun	dusun deyah	Dusun Deyah
duo	dupaninan agta	Dupaninan Agta
dup	duano	Duano
duq	dusun malang	Dusun Malang
dur	dii	Dii
dus	dumi	Dumi
dut	néerlandais ; flamand	Néerlandais ; Flamand
duu	drung	Drung
duv	duvle	Duvle
duw	dusun witu	Dusun Witu
dux	duungooma	Duungooma
duy	dicamay agta	Dicamay Agta
duz	duli-gey	Duli-Gey
dva	duau	Duau
dwa	diri	Diri
dwk	dawik kui	Dawik Kui
dwr	dawro	Dawro
dws	dutton world speedwords	Dutton World Speedwords
dwu	dhuwal	Dhuwal
dww	dawawa	Dawawa
dwy	dhuwaya	Dhuwaya
dwz	dewas rai	Dewas Rai
dya	dyan	Dyan
dyb	dyaberdyaber	Dyaberdyaber
dyd	dyugun	Dyugun
dyg	villa viciosa agta	Villa Viciosa Agta
dyi	djimini senoufo	Djimini Senoufo
dym	yanda dom dogon	Yanda Dom Dogon
dyn	dyangadi	Dyangadi
dyo	jola-fonyi	Jola-Fonyi
dyu	dioula	Dioula
dyy	djabugay	Djabugay
dza	tunzu	Tunzu
dze	djiwarli	Djiwarli
dzg	dazaga	Dazaga
dzl	dzalakha	Dzalakha
dzn	dzando	Dzando
dzo	dzongkha	Dzongkha
eaa	karenggapa	Karenggapa
ebc	beginci	Beginci
ebg	ebughu	Ebughu
ebk	eastern bontok	Eastern Bontok
ebo	teke-ebo	Teke-Ebo
ebr	ebrié	Ebrié
ebu	embu	Embu
ecr	eteocretan	Eteocretan
ecs	ecuadorian sign language	Ecuadorian Sign Language
ecy	eteocypriot	Eteocypriot
eee	e	E
efa	efai	Efai
efe	efe	Efe
efi	efik	Efik
ega	ega	Ega
egl	emilian	Emilian
egm	benamanga	Benamanga
ego	eggon	Eggon
egy	égyptien	Égyptien
ehs	miyakubo sign language	Miyakubo Sign Language
ehu	ehueun	Ehueun
eip	eipomek	Eipomek
eit	eitiep	Eitiep
eiv	askopan	Askopan
eja	ejamat	Ejamat
eka	ekajuk	Ekajuk
eke	ekit	Ekit
ekg	ekari	Ekari
eki	eki	Eki
ekk	standard estonian	Standard Estonian
ekl	kol (bangladesh)	Kol (Bangladesh)
ekm	elip	Elip
eko	koti	Koti
ekp	ekpeye	Ekpeye
ekr	yace	Yace
eky	eastern kayah	Eastern Kayah
ele	elepi	Elepi
elh	el hugeirat	El Hugeirat
eli	nding	Nding
elk	elkei	Elkei
ell	grec moderne (après 1453)	Grec Moderne (Après 1453)
elm	eleme	Eleme
elo	el molo	El Molo
elu	elu	Elu
elx	élamite	Élamite
ema	emai-iuleha-ora	Emai-Iuleha-Ora
emb	embaloh	Embaloh
eme	emerillon	Emerillon
emg	eastern meohang	Eastern Meohang
emi	mussau-emira	Mussau-Emira
emk	eastern maninkakan	Eastern Maninkakan
emm	mamulique	Mamulique
emn	eman	Eman
emp	northern emberá	Northern Emberá
emq	eastern minyag	Eastern Minyag
ems	pacific gulf yupik	Pacific Gulf Yupik
emu	eastern muria	Eastern Muria
emw	emplawas	Emplawas
emx	erromintxela	Erromintxela
emy	epigraphic mayan	Epigraphic Mayan
emz	mbessa	Mbessa
ena	apali	Apali
enb	markweeta	Markweeta
enc	en	En
end	ende	Ende
enf	forest enets	Forest Enets
eng	anglais	Anglais
enh	tundra enets	Tundra Enets
enl	enlhet	Enlhet
enm	anglais (moyen : 1100-1500)	Anglais (Moyen : 1100-1500)
enn	engenni	Engenni
eno	enggano	Enggano
enq	enga	Enga
enr	emumu	Emumu
enu	enu	Enu
env	enwan (edo state)	Enwan (Edo State)
enw	enwan (akwa ibom state)	Enwan (Akwa Ibom State)
enx	enxet	Enxet
eot	beti (côte d'ivoire)	Beti (Côte D'Ivoire)
epi	epie	Epie
epo	espéranto	Espéranto
era	eravallan	Eravallan
erg	sie	Sie
erh	eruwa	Eruwa
eri	ogea	Ogea
erk	south efate	South Efate
ero	horpa	Horpa
err	erre	Erre
ers	ersu	Ersu
ert	eritai	Eritai
erw	erokwanas	Erokwanas
ese	ese ejja	Ese Ejja
esg	aheri gondi	Aheri Gondi
esh	eshtehardi	Eshtehardi
esi	north alaskan inupiatun	North Alaskan Inupiatun
esk	northwest alaska inupiatun	Northwest Alaska Inupiatun
esl	egypt sign language	Egypt Sign Language
esm	esuma	Esuma
esn	salvadoran sign language	Salvadoran Sign Language
eso	estonian sign language	Estonian Sign Language
esq	esselen	Esselen
ess	central siberian yupik	Central Siberian Yupik
est	estonien	Estonien
esu	central yupik	Central Yupik
esy	eskayan	Eskayan
etb	etebi	Etebi
etc	etchemin	Etchemin
eth	ethiopian sign language	Ethiopian Sign Language
etn	eton (vanuatu)	Eton (Vanuatu)
eto	eton (cameroon)	Eton (Cameroon)
etr	edolo	Edolo
ets	yekhee	Yekhee
ett	etruscan	Etruscan
etu	ejagham	Ejagham
etx	eten	Eten
etz	semimi	Semimi
eus	basque	Basque
eve	even	Even
evh	uvbie	Uvbie
evn	evenki	Evenki
ewe	éwé	Éwé
ewo	ewondo	Ewondo
ext	extremaduran	Extremaduran
eya	eyak	Eyak
eyo	keiyo	Keiyo
eza	ezaa	Ezaa
eze	uzekwe	Uzekwe
faa	fasu	Fasu
fab	fa d'ambu	Fa D'Ambu
fad	wagi	Wagi
faf	fagani	Fagani
fag	finongan	Finongan
fah	baissa fali	Baissa Fali
fai	faiwol	Faiwol
faj	faita	Faita
fak	fang (cameroon)	Fang (Cameroon)
fal	south fali	South Fali
fam	fam	Fam
fan	fang	Fang
fao	féroïen	Féroïen
fap	paloor	Paloor
far	fataleka	Fataleka
fas	persan	Persan
fat	fanti	Fanti
fau	fayu	Fayu
fax	fala	Fala
fay	southwestern fars	Southwestern Fars
faz	northwestern fars	Northwestern Fars
fbl	west albay bikol	West Albay Bikol
fcs	quebec sign language	Quebec Sign Language
fer	feroge	Feroge
ffi	foia foia	Foia Foia
ffm	maasina fulfulde	Maasina Fulfulde
fgr	fongoro	Fongoro
fia	nobiin	Nobiin
fie	fyer	Fyer
fif	faifi	Faifi
fij	fidjien	Fidjien
fil	filipino ; pilipino	Filipino ; Pilipino
fin	finnois	Finnois
fip	fipa	Fipa
fir	firan	Firan
fit	tornedalen finnish	Tornedalen Finnish
fiu	finno-ougriennes, langues	Finno-Ougriennes, Langues
fiw	fiwaga	Fiwaga
fkk	kirya-konzel	Kirya-Konzel
fkv	kven finnish	Kven Finnish
fla	kalispel-pend d'oreille	Kalispel-Pend D'Oreille
flh	foau	Foau
fli	fali	Fali
fll	north fali	North Fali
fln	flinders island	Flinders Island
flr	fuliiru	Fuliiru
fly	flaaitaal	Flaaitaal
fmp	fe'fe'	Fe'Fe'
fmu	far western muria	Far Western Muria
fnb	fanbak	Fanbak
fng	fanagalo	Fanagalo
fni	fania	Fania
fod	foodo	Foodo
foi	foi	Foi
fom	foma	Foma
fon	fon	Fon
for	fore	Fore
fos	siraya	Siraya
fpe	fernando po creole english	Fernando Po Creole English
fqs	fas	Fas
fra	français	Français
frc	cajun french	Cajun French
frd	fordata	Fordata
frk	frankish	Frankish
frm	français moyen (1400-1600)	Français Moyen (1400-1600)
fro	français ancien (842-ca. 1400)	Français Ancien (842-Ca. 1400)
frp	francoprovençal [arpitan]	Francoprovençal [Arpitan]
frq	forak	Forak
frr	frison septentrional	Frison Septentrional
frr	northern frisian	Northern Frisian
frs	frison oriental	Frison Oriental
frs	eastern frisian	Eastern Frisian
frt	fortsenal	Fortsenal
fry	frison occidental	Frison Occidental
fse	finnish sign language	Finnish Sign Language
fsl	langue des signes française	Langue Des Signes Française
fss	finland-swedish sign language	Finland-Swedish Sign Language
fub	adamawa fulfulde	Adamawa Fulfulde
fuc	pulaar	Pulaar
fud	futunien	Futunien
fue	borgu fulfulde	Borgu Fulfulde
fuf	pular	Pular
fuh	western niger fulfulde	Western Niger Fulfulde
fui	bagirmi fulfulde	Bagirmi Fulfulde
fuj	ko	Ko
ful	peul	Peul
fum	fum	Fum
fun	fulniô	Fulniô
fuq	central-eastern niger fulfulde	Central-Eastern Niger Fulfulde
fur	frioulan	Frioulan
fut	futuna-aniwa	Futuna-Aniwa
fuu	furu	Furu
fuv	nigerian fulfulde	Nigerian Fulfulde
fuy	fuyug	Fuyug
fvr	fur	Fur
fwa	fwài	Fwài
fwe	fwe	Fwe
gaa	ga	Ga
gab	gabri	Gabri
gac	mixed great andamanese	Mixed Great Andamanese
gad	gaddang	Gaddang
gae	guarequena	Guarequena
gaf	gende	Gende
gag	gagauz	Gagauz
gah	alekano	Alekano
gai	borei	Borei
gaj	gadsup	Gadsup
gak	gamkonora	Gamkonora
gal	galolen	Galolen
gam	kandawo	Kandawo
gan	gan chinese	Gan Chinese
gao	gants	Gants
gap	gal	Gal
gaq	gata'	Gata'
gar	galeya	Galeya
gas	adiwasi garasia	Adiwasi Garasia
gat	kenati	Kenati
gau	mudhili gadaba	Mudhili Gadaba
gaw	nobonob	Nobonob
gax	borana-arsi-guji oromo	Borana-Arsi-Guji Oromo
gay	gayo	Gayo
gaz	west central oromo	West Central Oromo
gba	gbaya	Gbaya
gbb	kaytetye	Kaytetye
gbd	karajarri	Karajarri
gbe	niksek	Niksek
gbf	gaikundi	Gaikundi
gbg	gbanziri	Gbanziri
gbh	defi gbe	Defi Gbe
gbi	galela	Galela
gbj	bodo gadaba	Bodo Gadaba
gbk	gaddi	Gaddi
gbl	gamit	Gamit
gbm	garhwali	Garhwali
gbn	mo'da	Mo'Da
gbo	northern grebo	Northern Grebo
gbp	gbaya-bossangoa	Gbaya-Bossangoa
gbq	gbaya-bozoum	Gbaya-Bozoum
gbr	gbagyi	Gbagyi
gbs	gbesi gbe	Gbesi Gbe
gbu	gagadu	Gagadu
gbv	gbanu	Gbanu
gbw	gabi-gabi	Gabi-Gabi
gbx	eastern xwla gbe	Eastern Xwla Gbe
gby	gbari	Gbari
gbz	zoroastrian dari	Zoroastrian Dari
gcc	mali	Mali
gcd	ganggalida	Ganggalida
gce	galice	Galice
gcf	créole guadeloupéen	Créole Guadeloupéen
gcl	grenadian creole english	Grenadian Creole English
gcn	gaina	Gaina
gcr	créole guyanais	Créole Guyanais
gct	colonia tovar german	Colonia Tovar German
gda	gade lohar	Gade Lohar
gdb	pottangi ollar gadaba	Pottangi Ollar Gadaba
gdc	gugu badhun	Gugu Badhun
gdd	gedaged	Gedaged
gde	gude	Gude
gdf	guduf-gava	Guduf-Gava
gdg	ga'dang	Ga'Dang
gdh	gadjerawang	Gadjerawang
gdi	gundi	Gundi
gdj	gurdjar	Gurdjar
gdk	gadang	Gadang
gdl	dirasha	Dirasha
gdm	laal	Laal
gdn	umanakaina	Umanakaina
gdo	ghodoberi	Ghodoberi
gdq	mehri	Mehri
gdr	wipi	Wipi
gds	ghandruk sign language	Ghandruk Sign Language
gdt	kungardutyi	Kungardutyi
gdu	gudu	Gudu
gdx	godwari	Godwari
gea	geruma	Geruma
geb	kire	Kire
gec	gboloo grebo	Gboloo Grebo
ged	gade	Gade
gef	gerai	Gerai
geg	gengle	Gengle
geh	hutterite german	Hutterite German
gei	gebe	Gebe
gej	gen	Gen
gek	ywom	Ywom
gel	ut-ma'in	Ut-Ma'In
gem	germaniques, langues	Germaniques, Langues
geq	geme	Geme
ges	geser-gorom	Geser-Gorom
gev	eviya	Eviya
gew	gera	Gera
gex	garre	Garre
gey	enya	Enya
gez	guèze	Guèze
gfk	patpatar	Patpatar
gft	gafat	Gafat
gga	gao	Gao
ggb	gbii	Gbii
ggd	gugadj	Gugadj
gge	gurr-goni	Gurr-Goni
ggg	gurgula	Gurgula
ggk	kungarakany	Kungarakany
ggl	ganglau	Ganglau
ggt	gitua	Gitua
ggu	gagu	Gagu
ggw	gogodala	Gogodala
gha	ghadamčs	Ghadamčs
ghc	hiberno-scottish gaelic	Hiberno-Scottish Gaelic
ghe	southern ghale	Southern Ghale
ghh	northern ghale	Northern Ghale
ghk	geko karen	Geko Karen
ghl	ghulfan	Ghulfan
ghn	ghanongga	Ghanongga
gho	ghomara	Ghomara
ghr	ghera	Ghera
ghs	guhu-samane	Guhu-Samane
ght	kuke	Kuke
gia	kija	Kija
gib	gibanawa	Gibanawa
gic	gail	Gail
gid	gidar	Gidar
gie	gabogbo	Gabogbo
gig	goaria	Goaria
gih	githabul	Githabul
gii	girirra	Girirra
gil	kiribati	Kiribati
gim	gimi (eastern highlands)	Gimi (Eastern Highlands)
gin	hinukh	Hinukh
gip	gimi (west new britain)	Gimi (West New Britain)
giq	green gelao	Green Gelao
gir	red gelao	Red Gelao
gis	north giziga	North Giziga
git	gitxsan	Gitxsan
giu	mulao	Mulao
giw	white gelao	White Gelao
gix	gilima	Gilima
giy	giyug	Giyug
giz	south giziga	South Giziga
gjk	kachi koli	Kachi Koli
gjm	gunditjmara	Gunditjmara
gjn	gonja	Gonja
gjr	gurindji kriol	Gurindji Kriol
gju	gujari	Gujari
gka	guya	Guya
gkd	magi (madang province)	Magi (Madang Province)
gke	ndai	Ndai
gkn	gokana	Gokana
gko	kok-nar	Kok-Nar
gkp	guinea kpelle	Guinea Kpelle
gku	ungkue	Ungkue
gla	gaélique ; gaélique écossais	Gaélique ; Gaélique Écossais
glb	belning	Belning
glc	bon gula	Bon Gula
gld	nanai	Nanai
gle	irlandais	Irlandais
glg	galicien	Galicien
glh	northwest pashai	Northwest Pashai
glj	gula iro	Gula Iro
glk	gilaki	Gilaki
gll	garlali	Garlali
glo	galambu	Galambu
glr	glaro-twabo	Glaro-Twabo
glu	gula (chad)	Gula (Chad)
glv	manx ; mannois	Manx ; Mannois
glw	glavda	Glavda
gly	gule	Gule
gma	gambera	Gambera
gmb	gula'alaa	Gula'Alaa
gmd	mághdě	Mághdě
gmg	magiyi	Magiyi
gmh	allemand, moyen haut (ca. 1050-1500)	Allemand, Moyen Haut (Ca. 1050-1500)
gml	middle low german	Middle Low German
gmm	gbaya-mbodomo	Gbaya-Mbodomo
gmn	gimnime	Gimnime
gmr	mirning	Mirning
gmu	gumalu	Gumalu
gmv	gamo	Gamo
gmx	magoma	Magoma
gmy	mycenaean greek	Mycenaean Greek
gmz	mgbolizhia	Mgbolizhia
gna	kaansa	Kaansa
gnb	gangte	Gangte
gnc	guanche	Guanche
gnd	zulgo-gemzek	Zulgo-Gemzek
gne	ganang	Ganang
gng	ngangam	Ngangam
gnh	lere	Lere
gni	gooniyandi	Gooniyandi
gnj	ngen	Ngen
gnl	gangulu	Gangulu
gnm	ginuman	Ginuman
gnn	gumatj	Gumatj
gno	northern gondi	Northern Gondi
gnq	gana	Gana
gnr	gureng gureng	Gureng Gureng
gnt	guntai	Guntai
gnu	gnau	Gnau
gnw	western bolivian guaraní	Western Bolivian Guaraní
gnz	ganzi	Ganzi
goa	guro	Guro
gob	playero	Playero
goc	gorakor	Gorakor
god	godié	Godié
goe	gongduk	Gongduk
gof	gofa	Gofa
gog	gogo	Gogo
goh	allemand, vieux haut (ca. 750-1050)	Allemand, Vieux Haut (Ca. 750-1050)
goi	gobasi	Gobasi
goj	gowlan	Gowlan
gok	gowli	Gowli
gol	gola	Gola
gom	goan konkani	Goan Konkani
gon	gond	Gond
goo	gone dau	Gone Dau
gop	yeretuar	Yeretuar
goq	gorap	Gorap
gor	gorontalo	Gorontalo
gos	gronings	Gronings
got	gothique	Gothique
gou	gavar	Gavar
gov	goo	Goo
gow	gorowa	Gorowa
gox	gobu	Gobu
goy	goundo	Goundo
goz	gozarkhani	Gozarkhani
gpa	gupa-abawa	Gupa-Abawa
gpe	ghanaian pidgin english	Ghanaian Pidgin English
gpn	taiap	Taiap
gqa	ga'anda	Ga'Anda
gqi	guiqiong	Guiqiong
gqn	guana (brazil)	Guana (Brazil)
gqr	gor	Gor
gqu	qau	Qau
gra	rajput garasia	Rajput Garasia
grb	grebo	Grebo
grc	grec ancien (jusqu'à 1453)	Grec Ancien (Jusqu'À 1453)
grd	guruntum-mbaaru	Guruntum-Mbaaru
grg	madi	Madi
grh	gbiri-niragu	Gbiri-Niragu
gri	ghari	Ghari
grj	southern grebo	Southern Grebo
grm	kota marudu talantang	Kota Marudu Talantang
grn	guarani	Guarani
gro	groma	Groma
grq	gorovu	Gorovu
grr	taznatit	Taznatit
grs	gresi	Gresi
grt	garo	Garo
gru	kistane	Kistane
grv	central grebo	Central Grebo
grw	gweda	Gweda
grx	guriaso	Guriaso
gry	barclayville grebo	Barclayville Grebo
grz	guramalum	Guramalum
gsc	gascon	Gascon
gse	ghanaian sign language	Ghanaian Sign Language
gsg	german sign language	German Sign Language
gsl	gusilay	Gusilay
gsm	guatemalan sign language	Guatemalan Sign Language
gsn	nema	Nema
gso	southwest gbaya	Southwest Gbaya
gsp	wasembo	Wasembo
gss	greek sign language	Greek Sign Language
gsw	alémanique ; suisse alémanique ; alsacien	Alémanique ; Suisse Alémanique ; Alsacien
gta	guató	Guató
gtu	aghu-tharnggala	Aghu-Tharnggala
gua	shiki	Shiki
gub	guajajára	Guajajára
guc	wayuu	Wayuu
gud	yocoboué dida	Yocoboué Dida
gue	gurindji	Gurindji
guf	gupapuyngu	Gupapuyngu
gug	paraguayan guaraní	Paraguayan Guaraní
guh	guahibo	Guahibo
gui	eastern bolivian guaraní	Eastern Bolivian Guaraní
guj	goudjrati	Goudjrati
guk	gumuz	Gumuz
gul	sea island creole english	Sea Island Creole English
gum	guambiano	Guambiano
gun	mbyá guaraní	Mbyá Guaraní
guo	guayabero	Guayabero
gup	gunwinggu	Gunwinggu
guq	aché	Aché
gur	farefare	Farefare
gus	guinean sign language	Guinean Sign Language
gut	maléku jaíka	Maléku Jaíka
guu	yanomamö	Yanomamö
guw	gun	Gun
gux	gourmanchéma	Gourmanchéma
guz	gusii	Gusii
gva	guana (paraguay)	Guana (Paraguay)
gvc	guanano	Guanano
gve	duwet	Duwet
gvf	golin	Golin
gvj	guajá	Guajá
gvl	gulay	Gulay
gvm	gurmana	Gurmana
gvn	kuku-yalanji	Kuku-Yalanji
gvo	gaviăo do jiparaná	Gaviăo Do Jiparaná
gvp	pará gaviăo	Pará Gaviăo
gvr	gurung	Gurung
gvs	gumawana	Gumawana
gvy	guyani	Guyani
gwa	mbato	Mbato
gwb	gwa	Gwa
gwc	gawri	Gawri
gwd	gawwada	Gawwada
gwe	gweno	Gweno
gwf	gowro	Gowro
gwg	moo	Moo
gwi	gwich'in	Gwich'In
gwj	gwi	Gwi
gwm	awngthim	Awngthim
gwn	gwandara	Gwandara
gwr	gwere	Gwere
gwt	gawar-bati	Gawar-Bati
gwu	guwamu	Guwamu
gww	kwini	Kwini
gwx	gua	Gua
gxx	wč southern	Wč Southern
gya	northwest gbaya	Northwest Gbaya
gyb	garus	Garus
gyd	kayardild	Kayardild
gye	gyem	Gyem
gyf	gungabula	Gungabula
gyg	gbayi	Gbayi
gyi	gyele	Gyele
gyl	gayil	Gayil
gym	ngäbere	Ngäbere
gyn	guyanese creole english	Guyanese Creole English
gyo	gyalsumdo	Gyalsumdo
gyr	guarayu	Guarayu
gyy	gunya	Gunya
gyz	geji	Geji
gza	ganza	Ganza
gzi	gazi	Gazi
gzn	gane	Gane
haa	han	Han
hab	hanoi sign language	Hanoi Sign Language
hac	gurani	Gurani
had	hatam	Hatam
hae	eastern oromo	Eastern Oromo
haf	haiphong sign language	Haiphong Sign Language
hag	hanga	Hanga
hah	hahon	Hahon
hai	haida	Haida
haj	hajong	Hajong
hak	hakka chinese	Hakka Chinese
hal	halang	Halang
ham	hewa	Hewa
han	hangaza	Hangaza
hao	hakö	Hakö
hap	hupla	Hupla
haq	ha	Ha
har	harari	Harari
has	haisla	Haisla
hat	haïtien; créole haïtien	Haïtien; Créole Haïtien
hau	haoussa	Haoussa
hav	havu	Havu
haw	hawaïen	Hawaïen
hax	southern haida	Southern Haida
hay	haya	Haya
haz	hazaragi	Hazaragi
hba	hamba	Hamba
hbb	huba	Huba
hbn	heiban	Heiban
hbo	ancient hebrew	Ancient Hebrew
hbs	code element for 639-1 has been deprecated	Code Element For 639-1 Has Been Deprecated
hbu	habu	Habu
hca	andaman creole hindi	Andaman Creole Hindi
hch	huichol	Huichol
hdn	northern haida	Northern Haida
hds	honduras sign language	Honduras Sign Language
hdy	hadiyya	Hadiyya
hea	northern qiandong miao	Northern Qiandong Miao
heb	hébreu	Hébreu
hed	herdé	Herdé
heg	helong	Helong
heh	hehe	Hehe
hei	heiltsuk	Heiltsuk
hem	hemba	Hemba
her	herero	Herero
hgm	hai//om	Hai//Om
hgw	haigwai	Haigwai
hhi	hoia hoia	Hoia Hoia
hhr	kerak	Kerak
hhy	hoyahoya	Hoyahoya
hia	lamang	Lamang
hib	hibito	Hibito
hid	hidatsa	Hidatsa
hif	fiji hindi	Fiji Hindi
hig	kamwe	Kamwe
hih	pamosu	Pamosu
hii	hinduri	Hinduri
hij	hijuk	Hijuk
hik	seit-kaitetu	Seit-Kaitetu
hil	hiligaynon	Hiligaynon
him	himachalis, langues ; paharis occidentales, langues	Himachalis, Langues ; Paharis Occidentales, Langues
hin	hindi	Hindi
hio	tsoa	Tsoa
hir	himarimă	Himarimă
hit	hittite	Hittite
hiw	hiw	Hiw
hix	hixkaryána	Hixkaryána
hji	haji	Haji
hka	kahe	Kahe
hke	hunde	Hunde
hkh	khah	Khah
hkk	hunjara-kaina ke	Hunjara-Kaina Ke
hkn	mel-khaonh	Mel-Khaonh
hks	hong kong sign language	Hong Kong Sign Language
hla	halia	Halia
hlb	halbi	Halbi
hld	halang doan	Halang Doan
hle	hlersu	Hlersu
hlt	matu chin	Matu Chin
hlu	hieroglyphic luwian	Hieroglyphic Luwian
hma	southern mashan hmong	Southern Mashan Hmong
hmb	humburi senni songhay	Humburi Senni Songhay
hmc	central huishui hmong	Central Huishui Hmong
hmd	large flowery miao	Large Flowery Miao
hme	eastern huishui hmong	Eastern Huishui Hmong
hmf	hmong don	Hmong Don
hmg	southwestern guiyang hmong	Southwestern Guiyang Hmong
hmh	southwestern huishui hmong	Southwestern Huishui Hmong
hmi	northern huishui hmong	Northern Huishui Hmong
hmj	ge	Ge
hmk	maek	Maek
hml	luopohe hmong	Luopohe Hmong
hmm	central mashan hmong	Central Mashan Hmong
hmn	hmong	Hmong
hmo	hiri motu	Hiri Motu
hmp	northern mashan hmong	Northern Mashan Hmong
hmq	eastern qiandong miao	Eastern Qiandong Miao
hmr	hmar	Hmar
hms	southern qiandong miao	Southern Qiandong Miao
hmt	hamtai	Hamtai
hmu	hamap	Hamap
hmv	hmong dô	Hmong Dô
hmw	western mashan hmong	Western Mashan Hmong
hmy	southern guiyang hmong	Southern Guiyang Hmong
hmz	hmong shua	Hmong Shua
hna	mina (cameroon)	Mina (Cameroon)
hnd	southern hindko	Southern Hindko
hne	chhattisgarhi	Chhattisgarhi
hng	hungu	Hungu
hnh	ani	Ani
hni	hani	Hani
hnj	hmong njua	Hmong Njua
hnn	hanunoo	Hanunoo
hno	northern hindko	Northern Hindko
hns	caribbean hindustani	Caribbean Hindustani
hnu	hung	Hung
hoa	hoava	Hoava
hob	mari (madang province)	Mari (Madang Province)
hoc	ho	Ho
hod	holma	Holma
hoe	horom	Horom
hoh	hobyót	Hobyót
hoi	holikachuk	Holikachuk
hoj	hadothi	Hadothi
hol	holu	Holu
hom	homa	Homa
hoo	holoholo	Holoholo
hop	hopi	Hopi
hor	horo	Horo
hos	ho chi minh city sign language	Ho Chi Minh City Sign Language
hot	hote	Hote
hov	hovongan	Hovongan
how	honi	Honi
hoy	holiya	Holiya
hoz	hozo	Hozo
hpo	hpon	Hpon
hps	hawai'i sign language (hsl)	Hawai'I Sign Language (Hsl)
hra	hrangkhol	Hrangkhol
hrc	niwer mil	Niwer Mil
hre	hre	Hre
hrk	haruku	Haruku
hrm	horned miao	Horned Miao
hro	haroi	Haroi
hrp	nhirrpi	Nhirrpi
hrt	hértevin	Hértevin
hru	hruso	Hruso
hrv	croate	Croate
hrw	warwar feni	Warwar Feni
hrx	hunsrik	Hunsrik
hrz	harzani	Harzani
hsb	haut-sorabe	Haut-Sorabe
hsh	hungarian sign language	Hungarian Sign Language
hsl	hausa sign language	Hausa Sign Language
hsn	xiang chinese	Xiang Chinese
hss	harsusi	Harsusi
hti	hoti	Hoti
hto	minica huitoto	Minica Huitoto
hts	hadza	Hadza
htu	hitu	Hitu
htx	middle hittite	Middle Hittite
hub	huambisa	Huambisa
huc	hua	Hua
hud	huaulu	Huaulu
hue	san francisco del mar huave	San Francisco Del Mar Huave
huf	humene	Humene
hug	huachipaeri	Huachipaeri
huh	huilliche	Huilliche
hui	huli	Huli
huj	northern guiyang hmong	Northern Guiyang Hmong
huk	hulung	Hulung
hul	hula	Hula
hum	hungana	Hungana
hun	hongrois	Hongrois
huo	hu	Hu
hup	hupa	Hupa
huq	tsat	Tsat
hur	halkomelem	Halkomelem
hus	huastec	Huastec
hut	humla	Humla
huu	murui huitoto	Murui Huitoto
huv	san mateo del mar huave	San Mateo Del Mar Huave
huw	hukumina	Hukumina
hux	nüpode huitoto	Nüpode Huitoto
huy	hulaulá	Hulaulá
huz	hunzib	Hunzib
hvc	haitian vodoun culture language	Haitian Vodoun Culture Language
hve	san dionisio del mar huave	San Dionisio Del Mar Huave
hvk	haveke	Haveke
hvn	sabu	Sabu
hvv	santa maría del mar huave	Santa María Del Mar Huave
hwa	wané	Wané
hwc	hawai'i creole english	Hawai'I Creole English
hwo	hwana	Hwana
hya	hya	Hya
hye	arménien	Arménien
hyw	western armenian	Western Armenian
iai	iaai	Iaai
ian	iatmul	Iatmul
iar	purari	Purari
iba	iban	Iban
ibb	ibibio	Ibibio
ibd	iwaidja	Iwaidja
ibe	akpes	Akpes
ibg	ibanag	Ibanag
ibh	bih	Bih
ibl	ibaloi	Ibaloi
ibm	agoi	Agoi
ibn	ibino	Ibino
ibo	igbo	Igbo
ibr	ibuoro	Ibuoro
ibu	ibu	Ibu
iby	ibani	Ibani
ica	ede ica	Ede Ica
ich	etkywan	Etkywan
icl	icelandic sign language	Icelandic Sign Language
icr	islander creole english	Islander Creole English
ida	idakho-isukha-tiriki	Idakho-Isukha-Tiriki
idb	indo-portuguese	Indo-Portuguese
idc	idon	Idon
idd	ede idaca	Ede Idaca
ide	idere	Idere
idi	idi	Idi
ido	ido	Ido
idr	indri	Indri
ids	idesa	Idesa
idt	idaté	Idaté
idu	idoma	Idoma
ifa	amganad ifugao	Amganad Ifugao
ifb	batad ifugao	Batad Ifugao
ife	ifč	Ifč
iff	ifo	Ifo
ifk	tuwali ifugao	Tuwali Ifugao
ifm	teke-fuumu	Teke-Fuumu
ifu	mayoyao ifugao	Mayoyao Ifugao
ify	keley-i kallahan	Keley-I Kallahan
igb	ebira	Ebira
ige	igede	Igede
igg	igana	Igana
igl	igala	Igala
igm	kanggape	Kanggape
ign	ignaciano	Ignaciano
igo	isebe	Isebe
igs	interglossa	Interglossa
igw	igwe	Igwe
ihb	iha based pidgin	Iha Based Pidgin
ihi	ihievbe	Ihievbe
ihp	iha	Iha
ihw	bidhawal	Bidhawal
iii	yi de Sichuan	Yi De Sichuan
iin	thiin	Thiin
ijc	izon	Izon
ije	biseni	Biseni
ijj	ede ije	Ede Ije
ijn	kalabari	Kalabari
ijo	ijo, langues	Ijo, Langues
ijs	southeast ijo	Southeast Ijo
ike	eastern canadian inuktitut	Eastern Canadian Inuktitut
iki	iko	Iko
ikk	ika	Ika
ikl	ikulu	Ikulu
iko	olulumo-ikom	Olulumo-Ikom
ikp	ikpeshi	Ikpeshi
ikr	ikaranggal	Ikaranggal
iks	inuit sign language	Inuit Sign Language
ikt	inuinnaqtun	Inuinnaqtun
iku	inuktitut	Inuktitut
ikv	iku-gora-ankwa	Iku-Gora-Ankwa
ikw	ikwere	Ikwere
ikx	ik	Ik
ikz	ikizu	Ikizu
ila	ile ape	Ile Ape
ilb	ila	Ila
ile	interlingue	Interlingue
ilg	garig-ilgar	Garig-Ilgar
ili	ili turki	Ili Turki
ilk	ilongot	Ilongot
ilm	iranun (malaysia)	Iranun (Malaysia)
ilo	ilocano	Ilocano
ilp	iranun (philippines)	Iranun (Philippines)
ils	international sign	International Sign
ilu	ili'uun	Ili'Uun
ilv	ilue	Ilue
ima	mala malasar	Mala Malasar
imi	anamgura	Anamgura
iml	miluk	Miluk
imn	imonda	Imonda
imo	imbongu	Imbongu
imr	imroing	Imroing
ims	marsian	Marsian
imt	imotong	Imotong
imy	milyan	Milyan
ina	interlingua (langue auxiliaire internationale)	Interlingua (Langue Auxiliaire Internationale)
inb	inga	Inga
inc	indo-aryennes, langues	Indo-Aryennes, Langues
ind	indonésien	Indonésien
ine	indo-européennes, langues	Indo-Européennes, Langues
ing	degexit'an	Degexit'An
inh	ingouche	Ingouche
inj	jungle inga	Jungle Inga
inl	indonesian sign language	Indonesian Sign Language
inm	minaean	Minaean
inn	isinai	Isinai
ino	inoke-yate	Inoke-Yate
inp	ińapari	Ińapari
ins	indian sign language	Indian Sign Language
int	intha	Intha
inz	ineseńo	Ineseńo
ior	inor	Inor
iou	tuma-irumu	Tuma-Irumu
iow	iowa-oto	Iowa-Oto
ipi	ipili	Ipili
ipk	inupiaq	Inupiaq
ipo	ipiko	Ipiko
iqu	iquito	Iquito
iqw	ikwo	Ikwo
ira	iraniennes, langues	Iraniennes, Langues
ire	iresim	Iresim
irh	irarutu	Irarutu
iri	rigwe	Rigwe
irk	iraqw	Iraqw
irn	irántxe	Irántxe
iro	iroquoises, langues	Iroquoises, Langues
irr	ir	Ir
iru	irula	Irula
irx	kamberau	Kamberau
iry	iraya	Iraya
isa	isabi	Isabi
isc	isconahua	Isconahua
isd	isnag	Isnag
ise	italian sign language	Italian Sign Language
isg	irish sign language	Irish Sign Language
ish	esan	Esan
isi	nkem-nkum	Nkem-Nkum
isk	ishkashimi	Ishkashimi
isl	islandais	Islandais
ism	masimasi	Masimasi
isn	isanzu	Isanzu
iso	isoko	Isoko
isr	israeli sign language	Israeli Sign Language
ist	istriot	Istriot
isu	isu (menchum division)	Isu (Menchum Division)
ita	italien	Italien
itb	binongan itneg	Binongan Itneg
itd	southern tidung	Southern Tidung
ite	itene	Itene
iti	inlaod itneg	Inlaod Itneg
itk	judeo-italian	Judeo-Italian
itl	itelmen	Itelmen
itm	itu mbon uzo	Itu Mbon Uzo
ito	itonama	Itonama
itr	iteri	Iteri
its	isekiri	Isekiri
itt	maeng itneg	Maeng Itneg
itv	itawit	Itawit
itw	ito	Ito
itx	itik	Itik
ity	moyadan itneg	Moyadan Itneg
itz	itzá	Itzá
ium	iu mien	Iu Mien
ivb	ibatan	Ibatan
ivv	ivatan	Ivatan
iwk	i-wak	I-Wak
iwm	iwam	Iwam
iwo	iwur	Iwur
iws	sepik iwam	Sepik Iwam
ixc	ixcatec	Ixcatec
ixl	ixil	Ixil
iya	iyayu	Iyayu
iyo	mesaka	Mesaka
iyx	yaka (congo)	Yaka (Congo)
izh	ingrian	Ingrian
izr	izere	Izere
izz	izii	Izii
jaa	jamamadí	Jamamadí
jab	hyam	Hyam
jac	popti'	Popti'
jad	jahanka	Jahanka
jae	yabem	Yabem
jaf	jara	Jara
jah	jah hut	Jah Hut
jaj	zazao	Zazao
jak	jakun	Jakun
jal	yalahatan	Yalahatan
jam	jamaican creole english	Jamaican Creole English
jan	jandai	Jandai
jao	yanyuwa	Yanyuwa
jaq	yaqay	Yaqay
jas	new caledonian javanese	New Caledonian Javanese
jat	jakati	Jakati
jau	yaur	Yaur
jav	javanais	Javanais
jax	jambi malay	Jambi Malay
jay	yan-nhangu	Yan-Nhangu
jaz	jawe	Jawe
jbe	judeo-berber	Judeo-Berber
jbi	badjiri	Badjiri
jbj	arandai	Arandai
jbk	barikewa	Barikewa
jbm	bijim	Bijim
jbn	nafusi	Nafusi
jbo	lojban	Lojban
jbr	jofotek-bromnya	Jofotek-Bromnya
jbt	jabutí	Jabutí
jbu	jukun takum	Jukun Takum
jbw	yawijibaya	Yawijibaya
jcs	jamaican country sign language	Jamaican Country Sign Language
jct	krymchak	Krymchak
jda	jad	Jad
jdg	jadgali	Jadgali
jdt	judeo-tat	Judeo-Tat
jeb	jebero	Jebero
jee	jerung	Jerung
jeh	jeh	Jeh
jei	yei	Yei
jek	jeri kuo	Jeri Kuo
jel	yelmek	Yelmek
jen	dza	Dza
jer	jere	Jere
jet	manem	Manem
jeu	jonkor bourmataguil	Jonkor Bourmataguil
jgb	ngbee	Ngbee
jge	judeo-georgian	Judeo-Georgian
jgk	gwak	Gwak
jgo	ngomba	Ngomba
jhi	jehai	Jehai
jhs	jhankot sign language	Jhankot Sign Language
jia	jina	Jina
jib	jibu	Jibu
jic	tol	Tol
jid	bu (kaduna state)	Bu (Kaduna State)
jie	jilbe	Jilbe
jig	jingulu	Jingulu
jih	stodsde	Stodsde
jii	jiiddu	Jiiddu
jil	jilim	Jilim
jim	jimi (cameroon)	Jimi (Cameroon)
jio	jiamao	Jiamao
jiq	guanyinqiao	Guanyinqiao
jit	jita	Jita
jiu	youle jinuo	Youle Jinuo
jiv	shuar	Shuar
jiy	buyuan jinuo	Buyuan Jinuo
jje	jejueo	Jejueo
jjr	bankal	Bankal
jka	kaera	Kaera
jkm	mobwa karen	Mobwa Karen
jko	kubo	Kubo
jkp	paku karen	Paku Karen
jkr	koro (india)	Koro (India)
jks	amami koniya sign language	Amami Koniya Sign Language
jku	labir	Labir
jle	ngile	Ngile
jls	jamaican sign language	Jamaican Sign Language
jma	dima	Dima
jmb	zumbun	Zumbun
jmc	machame	Machame
jmd	yamdena	Yamdena
jmi	jimi (nigeria)	Jimi (Nigeria)
jml	jumli	Jumli
jmn	makuri naga	Makuri Naga
jmr	kamara	Kamara
jms	mashi (nigeria)	Mashi (Nigeria)
jmw	mouwase	Mouwase
jmx	western juxtlahuaca mixtec	Western Juxtlahuaca Mixtec
jna	jangshung	Jangshung
jnd	jandavra	Jandavra
jng	yangman	Yangman
jni	janji	Janji
jnj	yemsa	Yemsa
jnl	rawat	Rawat
jns	jaunsari	Jaunsari
job	joba	Joba
jod	wojenaka	Wojenaka
jog	jogi	Jogi
jor	jorá	Jorá
jos	jordanian sign language	Jordanian Sign Language
jow	jowulu	Jowulu
jpa	jewish palestinian aramaic	Jewish Palestinian Aramaic
jpn	japonais	Japonais
jpr	judéo-persan	Judéo-Persan
jqr	jaqaru	Jaqaru
jra	jarai	Jarai
jrb	judeó-arabe	Judeó-Arabe
jrr	jiru	Jiru
jrt	jakattoe	Jakattoe
jru	japrería	Japrería
jsl	japanese sign language	Japanese Sign Language
jua	júma	Júma
jub	wannu	Wannu
juc	jurchen	Jurchen
jud	worodougou	Worodougou
juh	hőne	Hőne
jui	ngadjuri	Ngadjuri
juk	wapan	Wapan
jul	jirel	Jirel
jum	jumjum	Jumjum
jun	juang	Juang
juo	jiba	Jiba
jup	hupdë	Hupdë
jur	jurúna	Jurúna
jus	jumla sign language	Jumla Sign Language
jut	jutish	Jutish
juu	ju	Ju
juw	wăpha	Wăpha
juy	juray	Juray
jvd	javindo	Javindo
jvn	caribbean javanese	Caribbean Javanese
jwi	jwira-pepesa	Jwira-Pepesa
jya	jiarong	Jiarong
jye	judeo-yemeni arabic	Judeo-Yemeni Arabic
jyy	jaya	Jaya
kaa	karakalpak	Karakalpak
kab	kabyle	Kabyle
kac	kachin ; jingpho	Kachin ; Jingpho
kad	adara	Adara
kae	ketangalan	Ketangalan
kaf	katso	Katso
kag	kajaman	Kajaman
kah	kara (central african republic)	Kara (Central African Republic)
kai	karekare	Karekare
kaj	jju	Jju
kak	kalanguya	Kalanguya
kal	groenlandais	Groenlandais
kam	kamba	Kamba
kan	kannada	Kannada
kao	xaasongaxango	Xaasongaxango
kap	bezhta	Bezhta
kaq	capanahua	Capanahua
kar	karen, langues	Karen, Langues
kas	kashmiri	Kashmiri
kat	géorgien	Géorgien
kau	kanouri	Kanouri
kav	katukína	Katukína
kaw	kawi	Kawi
kax	kao	Kao
kay	kamayurá	Kamayurá
kaz	kazakh	Kazakh
kba	kalarko	Kalarko
kbb	kaxuiàna	Kaxuiàna
kbc	kadiwéu	Kadiwéu
kbd	kabardien	Kabardien
kbe	kanju	Kanju
kbg	khamba	Khamba
kbh	camsá	Camsá
kbi	kaptiau	Kaptiau
kbj	kari	Kari
kbk	grass koiari	Grass Koiari
kbl	kanembu	Kanembu
kbm	iwal	Iwal
kbn	kare (central african republic)	Kare (Central African Republic)
kbo	keliko	Keliko
kbp	kabiyč	Kabiyč
kbq	kamano	Kamano
kbr	kafa	Kafa
kbs	kande	Kande
kbt	abadi	Abadi
kbu	kabutra	Kabutra
kbv	dera (indonesia)	Dera (Indonesia)
kbw	kaiep	Kaiep
kbx	ap ma	Ap Ma
kby	manga kanuri	Manga Kanuri
kbz	duhwa	Duhwa
kca	khanty	Khanty
kcb	kawacha	Kawacha
kcc	lubila	Lubila
kcd	ngkàlmpw kanum	Ngkàlmpw Kanum
kce	kaivi	Kaivi
kcf	ukaan	Ukaan
kcg	tyap	Tyap
kch	vono	Vono
kci	kamantan	Kamantan
kcj	kobiana	Kobiana
kck	kalanga	Kalanga
kcl	kela (papua new guinea)	Kela (Papua New Guinea)
kcm	gula (central african republic)	Gula (Central African Republic)
kcn	nubi	Nubi
kco	kinalakna	Kinalakna
kcp	kanga	Kanga
kcq	kamo	Kamo
kcr	katla	Katla
kcs	koenoem	Koenoem
kct	kaian	Kaian
kcu	kami (tanzania)	Kami (Tanzania)
kcv	kete	Kete
kcw	kabwari	Kabwari
kcx	kachama-ganjule	Kachama-Ganjule
kcy	korandje	Korandje
kcz	konongo	Konongo
kda	worimi	Worimi
kdc	kutu	Kutu
kdd	yankunytjatjara	Yankunytjatjara
kde	makonde	Makonde
kdf	mamusi	Mamusi
kdg	seba	Seba
kdh	tem	Tem
kdi	kumam	Kumam
kdj	karamojong	Karamojong
kdk	numèè	Numèè
kdl	tsikimba	Tsikimba
kdm	kagoma	Kagoma
kdn	kunda	Kunda
kdp	kaningdon-nindem	Kaningdon-Nindem
kdq	koch	Koch
kdr	karaim	Karaim
kdt	kuy	Kuy
kdu	kadaru	Kadaru
kdw	koneraw	Koneraw
kdx	kam	Kam
kdy	keder	Keder
kdz	kwaja	Kwaja
kea	kabuverdianu	Kabuverdianu
keb	kélé	Kélé
kec	keiga	Keiga
ked	kerewe	Kerewe
kee	eastern keres	Eastern Keres
kef	kpessi	Kpessi
keg	tese	Tese
keh	keak	Keak
kei	kei	Kei
kej	kadar	Kadar
kek	kekchí	Kekchí
kel	kela (democratic republic of congo)	Kela (Democratic Republic Of Congo)
kem	kemak	Kemak
ken	kenyang	Kenyang
keo	kakwa	Kakwa
kep	kaikadi	Kaikadi
keq	kamar	Kamar
ker	kera	Kera
kes	kugbo	Kugbo
ket	ket	Ket
keu	akebu	Akebu
kev	kanikkaran	Kanikkaran
kew	west kewa	West Kewa
kex	kukna	Kukna
key	kupia	Kupia
kez	kukele	Kukele
kfa	kodava	Kodava
kfb	northwestern kolami	Northwestern Kolami
kfc	konda-dora	Konda-Dora
kfd	korra koraga	Korra Koraga
kfe	kota (india)	Kota (India)
kff	koya	Koya
kfg	kudiya	Kudiya
kfh	kurichiya	Kurichiya
kfi	kannada kurumba	Kannada Kurumba
kfj	kemiehua	Kemiehua
kfk	kinnauri	Kinnauri
kfl	kung	Kung
kfm	khunsari	Khunsari
kfn	kuk	Kuk
kfo	koro (côte d'ivoire)	Koro (Côte D'Ivoire)
kfp	korwa	Korwa
kfq	korku	Korku
kfr	kachhi	Kachhi
kfs	bilaspuri	Bilaspuri
kft	kanjari	Kanjari
kfu	katkari	Katkari
kfv	kurmukar	Kurmukar
kfw	kharam naga	Kharam Naga
kfx	kullu pahari	Kullu Pahari
kfy	kumaoni	Kumaoni
kfz	koromfé	Koromfé
kga	koyaga	Koyaga
kgb	kawe	Kawe
kge	komering	Komering
kgf	kube	Kube
kgg	kusunda	Kusunda
kgi	selangor sign language	Selangor Sign Language
kgj	gamale kham	Gamale Kham
kgk	kaiwá	Kaiwá
kgl	kunggari	Kunggari
kgm	karipúna	Karipúna
kgn	karingani	Karingani
kgo	krongo	Krongo
kgp	kaingang	Kaingang
kgq	kamoro	Kamoro
kgr	abun	Abun
kgs	kumbainggar	Kumbainggar
kgt	somyev	Somyev
kgu	kobol	Kobol
kgv	karas	Karas
kgw	karon dori	Karon Dori
kgx	kamaru	Kamaru
kgy	kyerung	Kyerung
kha	khasi	Khasi
khb	lü	Lü
khc	tukang besi north	Tukang Besi North
khd	bädi kanum	Bädi Kanum
khe	korowai	Korowai
khf	khuen	Khuen
khg	khams tibetan	Khams Tibetan
khh	kehu	Kehu
khi	khoïsan, langues	Khoïsan, Langues
khj	kuturmi	Kuturmi
khk	halh mongolian	Halh Mongolian
khl	lusi	Lusi
khm	khmer central	Khmer Central
khn	khandesi	Khandesi
kho	khotanais ; sakan	Khotanais ; Sakan
khp	kapori	Kapori
khq	koyra chiini songhay	Koyra Chiini Songhay
khr	kharia	Kharia
khs	kasua	Kasua
kht	khamti	Khamti
khu	nkhumbi	Nkhumbi
khv	khvarshi	Khvarshi
khw	khowar	Khowar
khx	kanu	Kanu
khy	kele (democratic republic of congo)	Kele (Democratic Republic Of Congo)
khz	keapara	Keapara
kia	kim	Kim
kib	koalib	Koalib
kic	kickapoo	Kickapoo
kid	koshin	Koshin
kie	kibet	Kibet
kif	eastern parbate kham	Eastern Parbate Kham
kig	kimaama	Kimaama
kih	kilmeri	Kilmeri
kii	kitsai	Kitsai
kij	kilivila	Kilivila
kik	kikuyu	Kikuyu
kil	kariya	Kariya
kim	karagas	Karagas
kin	rwanda	Rwanda
kio	kiowa	Kiowa
kip	sheshi kham	Sheshi Kham
kiq	kosadle	Kosadle
kir	kirghiz	Kirghiz
kis	kis	Kis
kit	agob	Agob
kiu	kirmanjki (individual language)	Kirmanjki (Individual Language)
kiv	kimbu	Kimbu
kiw	northeast kiwai	Northeast Kiwai
kix	khiamniungan naga	Khiamniungan Naga
kiy	kirikiri	Kirikiri
kiz	kisi	Kisi
kja	mlap	Mlap
kjb	q'anjob'al	Q'Anjob'Al
kjc	coastal konjo	Coastal Konjo
kjd	southern kiwai	Southern Kiwai
kje	kisar	Kisar
kjg	khmu	Khmu
kjh	khakas	Khakas
kji	zabana	Zabana
kjj	khinalugh	Khinalugh
kjk	highland konjo	Highland Konjo
kjl	western parbate kham	Western Parbate Kham
kjm	kháng	Kháng
kjn	kunjen	Kunjen
kjo	harijan kinnauri	Harijan Kinnauri
kjp	pwo eastern karen	Pwo Eastern Karen
kjq	western keres	Western Keres
kjr	kurudu	Kurudu
kjs	east kewa	East Kewa
kjt	phrae pwo karen	Phrae Pwo Karen
kju	kashaya	Kashaya
kjv	kaikavian literary language	Kaikavian Literary Language
kjx	ramopa	Ramopa
kjy	erave	Erave
kjz	bumthangkha	Bumthangkha
kka	kakanda	Kakanda
kkb	kwerisa	Kwerisa
kkc	odoodee	Odoodee
kkd	kinuku	Kinuku
kke	kakabe	Kakabe
kkf	kalaktang monpa	Kalaktang Monpa
kkg	mabaka valley kalinga	Mabaka Valley Kalinga
kkh	khün	Khün
kki	kagulu	Kagulu
kkj	kako	Kako
kkk	kokota	Kokota
kkl	kosarek yale	Kosarek Yale
kkm	kiong	Kiong
kkn	kon keu	Kon Keu
kko	karko	Karko
kkp	gugubera	Gugubera
kkq	kaeku	Kaeku
kkr	kir-balar	Kir-Balar
kks	giiwo	Giiwo
kkt	koi	Koi
kku	tumi	Tumi
kkv	kangean	Kangean
kkw	teke-kukuya	Teke-Kukuya
kkx	kohin	Kohin
kky	guugu yimidhirr	Guugu Yimidhirr
kkz	kaska	Kaska
kla	klamath-modoc	Klamath-Modoc
klb	kiliwa	Kiliwa
klc	kolbila	Kolbila
kld	gamilaraay	Gamilaraay
kle	kulung (nepal)	Kulung (Nepal)
klf	kendeje	Kendeje
klg	tagakaulo	Tagakaulo
klh	weliki	Weliki
kli	kalumpang	Kalumpang
klj	khalaj	Khalaj
klk	kono (nigeria)	Kono (Nigeria)
kll	kagan kalagan	Kagan Kalagan
klm	migum	Migum
kln	kalenjin	Kalenjin
klo	kapya	Kapya
klp	kamasa	Kamasa
klq	rumu	Rumu
klr	khaling	Khaling
kls	kalasha	Kalasha
klt	nukna	Nukna
klu	klao	Klao
klv	maskelynes	Maskelynes
klw	tado	Tado
klx	koluwawa	Koluwawa
kly	kalao	Kalao
klz	kabola	Kabola
kma	konni	Konni
kmb	kimbundu	Kimbundu
kmc	southern dong	Southern Dong
kmd	majukayang kalinga	Majukayang Kalinga
kme	bakole	Bakole
kmf	kare (papua new guinea)	Kare (Papua New Guinea)
kmg	kàte	Kàte
kmh	kalam	Kalam
kmi	kami (nigeria)	Kami (Nigeria)
kmj	kumarbhag paharia	Kumarbhag Paharia
kmk	limos kalinga	Limos Kalinga
kml	tanudan kalinga	Tanudan Kalinga
kmm	kom (india)	Kom (India)
kmn	awtuw	Awtuw
kmo	kwoma	Kwoma
kmp	gimme	Gimme
kmq	kwama	Kwama
kmr	northern kurdish	Northern Kurdish
kms	kamasau	Kamasau
kmt	kemtuik	Kemtuik
kmu	kanite	Kanite
kmv	karipúna creole french	Karipúna Creole French
kmw	komo (democratic republic of congo)	Komo (Democratic Republic Of Congo)
kmx	waboda	Waboda
kmy	koma	Koma
kmz	khorasani turkish	Khorasani Turkish
kna	dera (nigeria)	Dera (Nigeria)
knb	lubuagan kalinga	Lubuagan Kalinga
knc	central kanuri	Central Kanuri
knd	konda	Konda
kne	kankanaey	Kankanaey
knf	mankanya	Mankanya
kng	koongo	Koongo
kni	kanufi	Kanufi
knj	western kanjobal	Western Kanjobal
knk	kuranko	Kuranko
knl	keninjal	Keninjal
knm	kanamarí	Kanamarí
knn	konkani (individual language)	Konkani (Individual Language)
kno	kono (sierra leone)	Kono (Sierra Leone)
knp	kwanja	Kwanja
knq	kintaq	Kintaq
knr	kaningra	Kaningra
kns	kensiu	Kensiu
knt	panoan katukína	Panoan Katukína
knu	kono (guinea)	Kono (Guinea)
knv	tabo	Tabo
knw	kung-ekoka	Kung-Ekoka
knx	kendayan	Kendayan
kny	kanyok	Kanyok
knz	kalamsé	Kalamsé
koa	konomala	Konomala
koc	kpati	Kpati
kod	kodi	Kodi
koe	kacipo-bale suri	Kacipo-Bale Suri
kof	kubi	Kubi
kog	cogui	Cogui
koh	koyo	Koyo
koi	komi-permyak	Komi-Permyak
kok	konkani	Konkani
kol	kol (papua new guinea)	Kol (Papua New Guinea)
kom	kom	Kom
kon	kongo	Kongo
koo	konzo	Konzo
kop	waube	Waube
koq	kota (gabon)	Kota (Gabon)
kor	coréen	Coréen
kos	kosrae	Kosrae
kot	lagwan	Lagwan
kou	koke	Koke
kov	kudu-camo	Kudu-Camo
kow	kugama	Kugama
koy	koyukon	Koyukon
koz	korak	Korak
kpa	kutto	Kutto
kpb	mullu kurumba	Mullu Kurumba
kpc	curripaco	Curripaco
kpd	koba	Koba
kpe	kpellé	Kpellé
kpf	komba	Komba
kpg	kapingamarangi	Kapingamarangi
kph	kplang	Kplang
kpi	kofei	Kofei
kpj	karajá	Karajá
kpk	kpan	Kpan
kpl	kpala	Kpala
kpm	koho	Koho
kpn	kepkiriwát	Kepkiriwát
kpo	ikposo	Ikposo
kpq	korupun-sela	Korupun-Sela
kpr	korafe-yegha	Korafe-Yegha
kps	tehit	Tehit
kpt	karata	Karata
kpu	kafoa	Kafoa
kpv	komi-zyrian	Komi-Zyrian
kpw	kobon	Kobon
kpx	mountain koiali	Mountain Koiali
kpy	koryak	Koryak
kpz	kupsabiny	Kupsabiny
kqa	mum	Mum
kqb	kovai	Kovai
kqc	doromu-koki	Doromu-Koki
kqd	koy sanjaq surat	Koy Sanjaq Surat
kqe	kalagan	Kalagan
kqf	kakabai	Kakabai
kqg	khe	Khe
kqh	kisankasa	Kisankasa
kqi	koitabu	Koitabu
kqj	koromira	Koromira
kqk	kotafon gbe	Kotafon Gbe
kql	kyenele	Kyenele
kqm	khisa	Khisa
kqn	kaonde	Kaonde
kqo	eastern krahn	Eastern Krahn
kqp	kimré	Kimré
kqq	krenak	Krenak
kqr	kimaragang	Kimaragang
kqs	northern kissi	Northern Kissi
kqt	klias river kadazan	Klias River Kadazan
kqu	seroa	Seroa
kqv	okolod	Okolod
kqw	kandas	Kandas
kqx	mser	Mser
kqy	koorete	Koorete
kqz	korana	Korana
kra	kumhali	Kumhali
krb	karkin	Karkin
krc	karatchaï balkar	Karatchaï Balkar
krd	kairui-midiki	Kairui-Midiki
kre	panará	Panará
krf	koro (vanuatu)	Koro (Vanuatu)
krh	kurama	Kurama
kri	krio	Krio
krj	kinaray-a	Kinaray-A
krk	kerek	Kerek
krl	carélien	Carélien
krl	karelian	Karelian
krn	sapo	Sapo
kro	krou, langues	Krou, Langues
krp	korop	Korop
krr	krung	Krung
krs	gbaya (sudan)	Gbaya (Sudan)
krt	tumari kanuri	Tumari Kanuri
kru	kurukh	Kurukh
krv	kavet	Kavet
krw	western krahn	Western Krahn
krx	karon	Karon
kry	kryts	Kryts
krz	sota kanum	Sota Kanum
ksa	shuwa-zamani	Shuwa-Zamani
ksb	shambala	Shambala
ksc	southern kalinga	Southern Kalinga
ksd	kuanua	Kuanua
kse	kuni	Kuni
ksf	bafia	Bafia
ksg	kusaghe	Kusaghe
ksh	kölsch	Kölsch
ksi	krisa	Krisa
ksj	uare	Uare
ksk	kansa	Kansa
ksl	kumalu	Kumalu
ksm	kumba	Kumba
ksn	kasiguranin	Kasiguranin
kso	kofa	Kofa
ksp	kaba	Kaba
ksq	kwaami	Kwaami
ksr	borong	Borong
kss	southern kisi	Southern Kisi
kst	winyé	Winyé
ksu	khamyang	Khamyang
ksv	kusu	Kusu
ksw	s'gaw karen	S'Gaw Karen
ksx	kedang	Kedang
ksy	kharia thar	Kharia Thar
ksz	kodaku	Kodaku
kta	katua	Katua
ktb	kambaata	Kambaata
ktc	kholok	Kholok
ktd	kokata	Kokata
kte	nubri	Nubri
ktf	kwami	Kwami
ktg	kalkutung	Kalkutung
kth	karanga	Karanga
kti	north muyu	North Muyu
ktj	plapo krumen	Plapo Krumen
ktk	kaniet	Kaniet
ktl	koroshi	Koroshi
ktm	kurti	Kurti
ktn	karitiàna	Karitiàna
kto	kuot	Kuot
ktp	kaduo	Kaduo
ktq	katabaga	Katabaga
kts	south muyu	South Muyu
ktt	ketum	Ketum
ktu	kituba (democratic republic of congo)	Kituba (Democratic Republic Of Congo)
ktv	eastern katu	Eastern Katu
ktw	kato	Kato
ktx	kaxararí	Kaxararí
kty	kango (bas-uélé district)	Kango (Bas-Uélé District)
ktz	ju/'hoan	Ju/'Hoan
kua	kuanyama ; kwanyama	Kuanyama ; Kwanyama
kub	kutep	Kutep
kuc	kwinsu	Kwinsu
kud	auhelawa	Auhelawa
kue	kuman (papua new guinea)	Kuman (Papua New Guinea)
kuf	western katu	Western Katu
kug	kupa	Kupa
kuh	kushi	Kushi
kui	kuikúro-kalapálo	Kuikúro-Kalapálo
kuj	kuria	Kuria
kuk	kepo'	Kepo'
kul	kulere	Kulere
kum	koumyk	Koumyk
kun	kunama	Kunama
kuo	kumukio	Kumukio
kup	kunimaipa	Kunimaipa
kuq	karipuna	Karipuna
kur	kurde	Kurde
kus	kusaal	Kusaal
kut	kutenai	Kutenai
kuu	upper kuskokwim	Upper Kuskokwim
kuv	kur	Kur
kuw	kpagua	Kpagua
kux	kukatja	Kukatja
kuy	kuuku-ya'u	Kuuku-Ya'U
kuz	kunza	Kunza
kva	bagvalal	Bagvalal
kvb	kubu	Kubu
kvc	kove	Kove
kvd	kui (indonesia)	Kui (Indonesia)
kve	kalabakan	Kalabakan
kvf	kabalai	Kabalai
kvg	kuni-boazi	Kuni-Boazi
kvh	komodo	Komodo
kvi	kwang	Kwang
kvj	psikye	Psikye
kvk	korean sign language	Korean Sign Language
kvl	kayaw	Kayaw
kvm	kendem	Kendem
kvn	border kuna	Border Kuna
kvo	dobel	Dobel
kvp	kompane	Kompane
kvq	geba karen	Geba Karen
kvr	kerinci	Kerinci
kvt	lahta karen	Lahta Karen
kvu	yinbaw karen	Yinbaw Karen
kvv	kola	Kola
kvw	wersing	Wersing
kvx	parkari koli	Parkari Koli
kvy	yintale karen	Yintale Karen
kvz	tsakwambo	Tsakwambo
kwa	dàw	Dàw
kwb	kwa	Kwa
kwc	likwala	Likwala
kwd	kwaio	Kwaio
kwe	kwerba	Kwerba
kwf	kwara'ae	Kwara'Ae
kwg	sara kaba deme	Sara Kaba Deme
kwh	kowiai	Kowiai
kwi	awa-cuaiquer	Awa-Cuaiquer
kwj	kwanga	Kwanga
kwk	kwakiutl	Kwakiutl
kwl	kofyar	Kofyar
kwm	kwambi	Kwambi
kwn	kwangali	Kwangali
kwo	kwomtari	Kwomtari
kwp	kodia	Kodia
kwr	kwer	Kwer
kws	kwese	Kwese
kwt	kwesten	Kwesten
kwu	kwakum	Kwakum
kwv	sara kaba náŕ	Sara Kaba Náŕ
kww	kwinti	Kwinti
kwx	khirwar	Khirwar
kwy	san salvador kongo	San Salvador Kongo
kwz	kwadi	Kwadi
kxa	kairiru	Kairiru
kxb	krobu	Krobu
kxc	konso	Konso
kxd	brunei	Brunei
kxf	manumanaw karen	Manumanaw Karen
kxh	karo (ethiopia)	Karo (Ethiopia)
kxi	keningau murut	Keningau Murut
kxj	kulfa	Kulfa
kxk	zayein karen	Zayein Karen
kxm	northern khmer	Northern Khmer
kxn	kanowit-tanjong melanau	Kanowit-Tanjong Melanau
kxo	kanoé	Kanoé
kxp	wadiyara koli	Wadiyara Koli
kxq	smärky kanum	Smärky Kanum
kxr	koro (papua new guinea)	Koro (Papua New Guinea)
kxs	kangjia	Kangjia
kxt	koiwat	Koiwat
kxv	kuvi	Kuvi
kxw	konai	Konai
kxx	likuba	Likuba
kxy	kayong	Kayong
kxz	kerewo	Kerewo
kya	kwaya	Kwaya
kyb	butbut kalinga	Butbut Kalinga
kyc	kyaka	Kyaka
kyd	karey	Karey
kye	krache	Krache
kyf	kouya	Kouya
kyg	keyagana	Keyagana
kyh	karok	Karok
kyi	kiput	Kiput
kyj	karao	Karao
kyk	kamayo	Kamayo
kyl	kalapuya	Kalapuya
kym	kpatili	Kpatili
kyn	northern binukidnon	Northern Binukidnon
kyo	kelon	Kelon
kyp	kang	Kang
kyq	kenga	Kenga
kyr	kuruáya	Kuruáya
kys	baram kayan	Baram Kayan
kyt	kayagar	Kayagar
kyu	western kayah	Western Kayah
kyv	kayort	Kayort
kyw	kudmali	Kudmali
kyx	rapoisi	Rapoisi
kyy	kambaira	Kambaira
kyz	kayabí	Kayabí
kza	western karaboro	Western Karaboro
kzb	kaibobo	Kaibobo
kzc	bondoukou kulango	Bondoukou Kulango
kzd	kadai	Kadai
kze	kosena	Kosena
kzf	da'a kaili	Da'A Kaili
kzg	kikai	Kikai
kzi	kelabit	Kelabit
kzk	kazukuru	Kazukuru
kzl	kayeli	Kayeli
kzm	kais	Kais
kzn	kokola	Kokola
kzo	kaningi	Kaningi
kzp	kaidipang	Kaidipang
kzq	kaike	Kaike
kzr	karang	Karang
kzs	sugut dusun	Sugut Dusun
kzu	kayupulau	Kayupulau
kzv	komyandaret	Komyandaret
kzw	karirí-xocó	Karirí-Xocó
kzx	kamarian	Kamarian
kzy	kango (tshopo district)	Kango (Tshopo District)
kzz	kalabra	Kalabra
laa	southern subanen	Southern Subanen
lab	linear a	Linear A
lac	lacandon	Lacandon
lad	judéo-espagnol	Judéo-Espagnol
lae	pattani	Pattani
laf	lafofa	Lafofa
lag	langi	Langi
lah	lahnda	Lahnda
lai	lambya	Lambya
laj	lango (uganda)	Lango (Uganda)
lal	lalia	Lalia
lam	lamba	Lamba
lan	laru	Laru
lao	lao	Lao
lap	laka (chad)	Laka (Chad)
laq	qabiao	Qabiao
lar	larteh	Larteh
las	lama (togo)	Lama (Togo)
lat	latin	Latin
lau	laba	Laba
lav	letton	Letton
law	lauje	Lauje
lax	tiwa	Tiwa
lay	lama bai	Lama Bai
laz	aribwatsa	Aribwatsa
lbb	label	Label
lbc	lakkia	Lakkia
lbe	lak	Lak
lbf	tinani	Tinani
lbg	laopang	Laopang
lbi	la'bi	La'Bi
lbj	ladakhi	Ladakhi
lbk	central bontok	Central Bontok
lbl	libon bikol	Libon Bikol
lbm	lodhi	Lodhi
lbn	rmeet	Rmeet
lbo	laven	Laven
lbq	wampar	Wampar
lbr	lohorung	Lohorung
lbs	libyan sign language	Libyan Sign Language
lbt	lachi	Lachi
lbu	labu	Labu
lbv	lavatbura-lamusong	Lavatbura-Lamusong
lbw	tolaki	Tolaki
lbx	lawangan	Lawangan
lby	lamalama	Lamalama
lbz	lardil	Lardil
lcc	legenyem	Legenyem
lcd	lola	Lola
lce	loncong	Loncong
lcf	lubu	Lubu
lch	luchazi	Luchazi
lcl	lisela	Lisela
lcm	tungag	Tungag
lcp	western lawa	Western Lawa
lcq	luhu	Luhu
lcs	lisabata-nuniali	Lisabata-Nuniali
lda	kla-dan	Kla-Dan
ldb	du~ya	Du~Ya
ldd	luri	Luri
ldg	lenyima	Lenyima
ldh	lamja-dengsa-tola	Lamja-Dengsa-Tola
ldi	laari	Laari
ldj	lemoro	Lemoro
ldk	leelau	Leelau
ldl	kaan	Kaan
ldm	landoma	Landoma
ldn	láadan	Láadan
ldo	loo	Loo
ldp	tso	Tso
ldq	lufu	Lufu
lea	lega-shabunda	Lega-Shabunda
leb	lala-bisa	Lala-Bisa
lec	leco	Leco
led	lendu	Lendu
lee	lyélé	Lyélé
lef	lelemi	Lelemi
leh	lenje	Lenje
lei	lemio	Lemio
lej	lengola	Lengola
lek	leipon	Leipon
lel	lele (democratic republic of congo)	Lele (Democratic Republic Of Congo)
lem	nomaande	Nomaande
len	lenca	Lenca
leo	leti (cameroon)	Leti (Cameroon)
lep	lepcha	Lepcha
leq	lembena	Lembena
ler	lenkau	Lenkau
les	lese	Lese
let	lesing-gelimi	Lesing-Gelimi
leu	kara (papua new guinea)	Kara (Papua New Guinea)
lev	lamma	Lamma
lew	ledo kaili	Ledo Kaili
lex	luang	Luang
ley	lemolang	Lemolang
lez	lezghien	Lezghien
lfa	lefa	Lefa
lfn	lingua franca nova	Lingua Franca Nova
lga	lungga	Lungga
lgb	laghu	Laghu
lgg	lugbara	Lugbara
lgh	laghuu	Laghuu
lgi	lengilu	Lengilu
lgk	lingarak	Lingarak
lgl	wala	Wala
lgm	lega-mwenga	Lega-Mwenga
lgn	t'apo	T'Apo
lgo	lango (south sudan)	Lango (South Sudan)
lgq	logba	Logba
lgr	lengo	Lengo
lgt	pahi	Pahi
lgu	longgu	Longgu
lgz	ligenza	Ligenza
lha	laha (viet nam)	Laha (Viet Nam)
lhh	laha (indonesia)	Laha (Indonesia)
lhi	lahu shi	Lahu Shi
lhl	lahul lohar	Lahul Lohar
lhm	lhomi	Lhomi
lhn	lahanan	Lahanan
lhp	lhokpu	Lhokpu
lhs	mlahsö	Mlahsö
lht	lo-toga	Lo-Toga
lhu	lahu	Lahu
lia	west-central limba	West-Central Limba
lib	likum	Likum
lic	hlai	Hlai
lid	nyindrou	Nyindrou
lie	likila	Likila
lif	limbu	Limbu
lig	ligbi	Ligbi
lih	lihir	Lihir
lij	parlers liguriens	Parlers Liguriens
lik	lika	Lika
lil	lillooet	Lillooet
lim	limbourgeois	Limbourgeois
lin	lingala	Lingala
lio	liki	Liki
lip	sekpele	Sekpele
liq	libido	Libido
lir	liberian english	Liberian English
lis	lisu	Lisu
lit	lituanien	Lituanien
liu	logorik	Logorik
liv	liv	Liv
liw	col	Col
lix	liabuku	Liabuku
liy	banda-bambari	Banda-Bambari
liz	libinza	Libinza
lja	golpa	Golpa
lje	rampi	Rampi
lji	laiyolo	Laiyolo
ljl	li'o	Li'O
ljp	lampung api	Lampung Api
ljw	yirandali	Yirandali
ljx	yuru	Yuru
lka	lakalei	Lakalei
lkb	kabras	Kabras
lkc	kucong	Kucong
lkd	lakondę	Lakondę
lke	kenyi	Kenyi
lkh	lakha	Lakha
lki	laki	Laki
lkj	remun	Remun
lkl	laeko-libuat	Laeko-Libuat
lkm	kalaamaya	Kalaamaya
lkn	lakon	Lakon
lko	khayo	Khayo
lkr	päri	Päri
lks	kisa	Kisa
lkt	lakota	Lakota
lku	kungkari	Kungkari
lky	lokoya	Lokoya
lla	lala-roba	Lala-Roba
llb	lolo	Lolo
llc	lele (guinea)	Lele (Guinea)
lld	ladin	Ladin
lle	lele (papua new guinea)	Lele (Papua New Guinea)
llf	hermit	Hermit
llg	lole	Lole
llh	lamu	Lamu
lli	teke-laali	Teke-Laali
llj	ladji ladji	Ladji Ladji
llk	lelak	Lelak
lll	lilau	Lilau
llm	lasalimu	Lasalimu
lln	lele (chad)	Lele (Chad)
llp	north efate	North Efate
llq	lolak	Lolak
lls	lithuanian sign language	Lithuanian Sign Language
llu	lau	Lau
llx	lauan	Lauan
lma	east limba	East Limba
lmb	merei	Merei
lmc	limilngan	Limilngan
lmd	lumun	Lumun
lme	pévé	Pévé
lmf	south lembata	South Lembata
lmg	lamogai	Lamogai
lmh	lambichhong	Lambichhong
lmi	lombi	Lombi
lmj	west lembata	West Lembata
lmk	lamkang	Lamkang
lml	hano	Hano
lmn	lambadi	Lambadi
lmo	lombard	Lombard
lmp	limbum	Limbum
lmq	lamatuka	Lamatuka
lmr	lamalera	Lamalera
lmu	lamenu	Lamenu
lmv	lomaiviti	Lomaiviti
lmw	lake miwok	Lake Miwok
lmx	laimbue	Laimbue
lmy	lamboya	Lamboya
lna	langbashe	Langbashe
lnb	mbalanhu	Mbalanhu
lnd	lundayeh	Lundayeh
lng	langobardic	Langobardic
lnh	lanoh	Lanoh
lni	daantanai'	Daantanai'
lnj	leningitij	Leningitij
lnl	south central banda	South Central Banda
lnm	langam	Langam
lnn	lorediakarkar	Lorediakarkar
lns	lamnso'	Lamnso'
lnu	longuda	Longuda
lnw	lanima	Lanima
lnz	lonzo	Lonzo
loa	loloda	Loloda
lob	lobi	Lobi
loc	inonhan	Inonhan
loe	saluan	Saluan
lof	logol	Logol
log	logo	Logo
loh	narim	Narim
loi	loma (côte d'ivoire)	Loma (Côte D'Ivoire)
loj	lou	Lou
lok	loko	Loko
lol	mongo	Mongo
lom	loma (liberia)	Loma (Liberia)
lon	malawi lomwe	Malawi Lomwe
loo	lombo	Lombo
lop	lopa	Lopa
loq	lobala	Lobala
lor	téén	Téén
los	loniu	Loniu
lot	otuho	Otuho
lou	louisiana creole	Louisiana Creole
lov	lopi	Lopi
low	tampias lobu	Tampias Lobu
lox	loun	Loun
loy	loke	Loke
loz	lozi	Lozi
lpa	lelepa	Lelepa
lpe	lepki	Lepki
lpn	long phuri naga	Long Phuri Naga
lpo	lipo	Lipo
lpx	lopit	Lopit
lqr	logir	Logir
lra	rara bakati'	Rara Bakati'
lrc	northern luri	Northern Luri
lre	laurentian	Laurentian
lrg	laragia	Laragia
lri	marachi	Marachi
lrk	loarki	Loarki
lrl	lari	Lari
lrm	marama	Marama
lrn	lorang	Lorang
lro	laro	Laro
lrr	southern yamphu	Southern Yamphu
lrt	larantuka malay	Larantuka Malay
lrv	larevat	Larevat
lrz	lemerig	Lemerig
lsa	lasgerdi	Lasgerdi
lsb	burundian sign language	Burundian Sign Language
lsc	albarradas sign language	Albarradas Sign Language
lsd	lishana deni	Lishana Deni
lse	lusengo	Lusengo
lsh	lish	Lish
lsi	lashi	Lashi
lsl	latvian sign language	Latvian Sign Language
lsm	saamia	Saamia
lsn	tibetan sign language	Tibetan Sign Language
lso	laos sign language	Laos Sign Language
lsp	panamanian sign language	Panamanian Sign Language
lsr	aruop	Aruop
lss	lasi	Lasi
lst	trinidad and tobago sign language	Trinidad And Tobago Sign Language
lsv	sivia sign language	Sivia Sign Language
lsw	seychelles sign language	Seychelles Sign Language
lsy	mauritian sign language	Mauritian Sign Language
ltc	late middle chinese	Late Middle Chinese
ltg	latgalian	Latgalian
lth	thur	Thur
lti	leti (indonesia)	Leti (Indonesia)
ltn	latundę	Latundę
lto	tsotso	Tsotso
lts	tachoni	Tachoni
ltu	latu	Latu
ltz	luxembourgeois	Luxembourgeois
lua	luba-lulua	Luba-Lulua
lub	luba-katanga	Luba-Katanga
luc	aringa	Aringa
lud	ludian	Ludian
lue	luvale	Luvale
luf	laua	Laua
lug	ganda	Ganda
lui	luiseno	Luiseno
luj	luna	Luna
luk	lunanakha	Lunanakha
lul	olu'bo	Olu'Bo
lum	luimbi	Luimbi
lun	lunda	Lunda
luo	luo (Kenya et Tanzanie)	Luo (Kenya Et Tanzanie)
lup	lumbu	Lumbu
luq	lucumi	Lucumi
lur	laura	Laura
lus	lushai	Lushai
lut	lushootseed	Lushootseed
luu	lumba-yakkha	Lumba-Yakkha
luv	luwati	Luwati
luw	luo (cameroon)	Luo (Cameroon)
luy	luyia	Luyia
luz	southern luri	Southern Luri
lva	maku'a	Maku'A
lvi	lavi	Lavi
lvk	lavukaleve	Lavukaleve
lvs	standard latvian	Standard Latvian
lvu	levuka	Levuka
lwa	lwalu	Lwalu
lwe	lewo eleng	Lewo Eleng
lwg	wanga	Wanga
lwh	white lachi	White Lachi
lwl	eastern lawa	Eastern Lawa
lwm	laomian	Laomian
lwo	luwo	Luwo
lws	malawian sign language	Malawian Sign Language
lwt	lewotobi	Lewotobi
lwu	lawu	Lawu
lww	lewo	Lewo
lxm	lakurumau	Lakurumau
lya	layakha	Layakha
lyg	lyngngam	Lyngngam
lyn	luyana	Luyana
lzh	literary chinese	Literary Chinese
lzl	litzlitz	Litzlitz
lzn	leinong naga	Leinong Naga
lzz	laz	Laz
maa	san jerónimo tecóatl mazatec	San Jerónimo Tecóatl Mazatec
mab	yutanduchi mixtec	Yutanduchi Mixtec
mad	madourais	Madourais
mae	bo-rukul	Bo-Rukul
maf	mafa	Mafa
mag	magahi	Magahi
mah	marshall	Marshall
mai	maithili	Maithili
maj	jalapa de díaz mazatec	Jalapa De Díaz Mazatec
mak	makassar	Makassar
mal	malayalam	Malayalam
mam	mam	Mam
man	mandingue	Mandingue
map	austronésiennes, langues	Austronésiennes, Langues
maq	chiquihuitlán mazatec	Chiquihuitlán Mazatec
mar	marathe	Marathe
mas	massaï	Massaï
mat	san francisco matlatzinca	San Francisco Matlatzinca
mau	huautla mazatec	Huautla Mazatec
mav	sateré-mawé	Sateré-Mawé
maw	mampruli	Mampruli
max	north moluccan malay	North Moluccan Malay
may	malais	Malais
maz	central mazahua	Central Mazahua
mba	higaonon	Higaonon
mbb	western bukidnon manobo	Western Bukidnon Manobo
mbc	macushi	Macushi
mbd	dibabawon manobo	Dibabawon Manobo
mbe	molale	Molale
mbf	baba malay	Baba Malay
mbh	mangseng	Mangseng
mbi	ilianen manobo	Ilianen Manobo
mbj	nadëb	Nadëb
mbk	malol	Malol
mbl	maxakalí	Maxakalí
mbm	ombamba	Ombamba
mbn	macaguán	Macaguán
mbo	mbo (cameroon)	Mbo (Cameroon)
mbp	malayo	Malayo
mbq	maisin	Maisin
mbr	nukak makú	Nukak Makú
mbs	sarangani manobo	Sarangani Manobo
mbt	matigsalug manobo	Matigsalug Manobo
mbu	mbula-bwazza	Mbula-Bwazza
mbv	mbulungish	Mbulungish
mbw	maring	Maring
mbx	mari (east sepik province)	Mari (East Sepik Province)
mby	memoni	Memoni
mbz	amoltepec mixtec	Amoltepec Mixtec
mca	maca	Maca
mcb	machiguenga	Machiguenga
mcc	bitur	Bitur
mcd	sharanahua	Sharanahua
mce	itundujia mixtec	Itundujia Mixtec
mcf	matsés	Matsés
mcg	mapoyo	Mapoyo
mch	maquiritari	Maquiritari
mci	mese	Mese
mcj	mvanip	Mvanip
mck	mbunda	Mbunda
mcl	macaguaje	Macaguaje
mcm	malaccan creole portuguese	Malaccan Creole Portuguese
mcn	masana	Masana
mco	coatlán mixe	Coatlán Mixe
mcp	makaa	Makaa
mcq	ese	Ese
mcr	menya	Menya
mcs	mambai	Mambai
mct	mengisa	Mengisa
mcu	cameroon mambila	Cameroon Mambila
mcv	minanibai	Minanibai
mcw	mawa (chad)	Mawa (Chad)
mcx	mpiemo	Mpiemo
mcy	south watut	South Watut
mcz	mawan	Mawan
mda	mada (nigeria)	Mada (Nigeria)
mdb	morigi	Morigi
mdc	male (papua new guinea)	Male (Papua New Guinea)
mdd	mbum	Mbum
mde	maba (chad)	Maba (Chad)
mdf	moksa	Moksa
mdg	massalat	Massalat
mdh	maguindanaon	Maguindanaon
mdi	mamvu	Mamvu
mdj	mangbetu	Mangbetu
mdk	mangbutu	Mangbutu
mdl	maltese sign language	Maltese Sign Language
mdm	mayogo	Mayogo
mdn	mbati	Mbati
mdp	mbala	Mbala
mdq	mbole	Mbole
mdr	mandar	Mandar
mds	maria (papua new guinea)	Maria (Papua New Guinea)
mdt	mbere	Mbere
mdu	mboko	Mboko
mdv	santa lucía monteverde mixtec	Santa Lucía Monteverde Mixtec
mdw	mbosi	Mbosi
mdx	dizin	Dizin
mdy	male (ethiopia)	Male (Ethiopia)
mdz	suruí do pará	Suruí Do Pará
mea	menka	Menka
meb	ikobi	Ikobi
mec	marra	Marra
med	melpa	Melpa
mee	mengen	Mengen
mef	megam	Megam
meh	southwestern tlaxiaco mixtec	Southwestern Tlaxiaco Mixtec
mei	midob	Midob
mej	meyah	Meyah
mek	mekeo	Mekeo
mel	central melanau	Central Melanau
mem	mangala	Mangala
men	mendé	Mendé
meo	kedah malay	Kedah Malay
mep	miriwoong	Miriwoong
meq	merey	Merey
mer	meru	Meru
mes	masmaje	Masmaje
met	mato	Mato
meu	motu	Motu
mev	mano	Mano
mew	maaka	Maaka
mey	hassaniyya	Hassaniyya
mez	menominee	Menominee
mfa	pattani malay	Pattani Malay
mfb	bangka	Bangka
mfc	mba	Mba
mfd	mendankwe-nkwen	Mendankwe-Nkwen
mfe	morisyen	Morisyen
mff	naki	Naki
mfg	mogofin	Mogofin
mfh	matal	Matal
mfi	wandala	Wandala
mfj	mefele	Mefele
mfk	north mofu	North Mofu
mfl	putai	Putai
mfm	marghi south	Marghi South
mfn	cross river mbembe	Cross River Mbembe
mfo	mbe	Mbe
mfp	makassar malay	Makassar Malay
mfq	moba	Moba
mfr	marrithiyel	Marrithiyel
mfs	mexican sign language	Mexican Sign Language
mft	mokerang	Mokerang
mfu	mbwela	Mbwela
mfv	mandjak	Mandjak
mfw	mulaha	Mulaha
mfx	melo	Melo
mfy	mayo	Mayo
mfz	mabaan	Mabaan
mga	irlandais moyen (900-1200)	Irlandais Moyen (900-1200)
mgb	mararit	Mararit
mgc	morokodo	Morokodo
mgd	moru	Moru
mge	mango	Mango
mgf	maklew	Maklew
mgg	mpumpong	Mpumpong
mgh	makhuwa-meetto	Makhuwa-Meetto
mgi	lijili	Lijili
mgj	abureni	Abureni
mgk	mawes	Mawes
mgl	maleu-kilenge	Maleu-Kilenge
mgm	mambae	Mambae
mgn	mbangi	Mbangi
mgo	meta'	Meta'
mgp	eastern magar	Eastern Magar
mgq	malila	Malila
mgr	mambwe-lungu	Mambwe-Lungu
mgs	manda (tanzania)	Manda (Tanzania)
mgt	mongol	Mongol
mgu	mailu	Mailu
mgv	matengo	Matengo
mgw	matumbi	Matumbi
mgy	mbunga	Mbunga
mgz	mbugwe	Mbugwe
mha	manda (india)	Manda (India)
mhb	mahongwe	Mahongwe
mhc	mocho	Mocho
mhd	mbugu	Mbugu
mhe	besisi	Besisi
mhf	mamaa	Mamaa
mhg	margu	Margu
mhi	ma'di	Ma'Di
mhj	mogholi	Mogholi
mhk	mungaka	Mungaka
mhl	mauwake	Mauwake
mhm	makhuwa-moniga	Makhuwa-Moniga
mhn	mócheno	Mócheno
mho	mashi (zambia)	Mashi (Zambia)
mhp	balinese malay	Balinese Malay
mhq	mandan	Mandan
mhr	eastern mari	Eastern Mari
mhs	buru (indonesia)	Buru (Indonesia)
mht	mandahuaca	Mandahuaca
mhu	digaro-mishmi	Digaro-Mishmi
mhw	mbukushu	Mbukushu
mhx	maru	Maru
mhy	ma'anyan	Ma'Anyan
mhz	mor (mor islands)	Mor (Mor Islands)
mia	miami	Miami
mib	atatláhuca mixtec	Atatláhuca Mixtec
mic	mi'kmaq ; micmac	Mi'Kmaq ; Micmac
mid	mandaic	Mandaic
mie	ocotepec mixtec	Ocotepec Mixtec
mif	mofu-gudur	Mofu-Gudur
mig	san miguel el grande mixtec	San Miguel El Grande Mixtec
mih	chayuco mixtec	Chayuco Mixtec
mii	chigmecatitlán mixtec	Chigmecatitlán Mixtec
mij	abar	Abar
mik	mikasuki	Mikasuki
mil	peńoles mixtec	Peńoles Mixtec
mim	alacatlatzala mixtec	Alacatlatzala Mixtec
min	minangkabau	Minangkabau
mio	pinotepa nacional mixtec	Pinotepa Nacional Mixtec
mip	apasco-apoala mixtec	Apasco-Apoala Mixtec
miq	mískito	Mískito
mir	isthmus mixe	Isthmus Mixe
mis	uncoded languages	Uncoded Languages
mit	southern puebla mixtec	Southern Puebla Mixtec
miu	cacaloxtepec mixtec	Cacaloxtepec Mixtec
miw	akoye	Akoye
mix	mixtepec mixtec	Mixtepec Mixtec
miy	ayutla mixtec	Ayutla Mixtec
miz	coatzospan mixtec	Coatzospan Mixtec
mjb	makalero	Makalero
mjc	san juan colorado mixtec	San Juan Colorado Mixtec
mjd	northwest maidu	Northwest Maidu
mje	muskum	Muskum
mjg	tu	Tu
mjh	mwera (nyasa)	Mwera (Nyasa)
mji	kim mun	Kim Mun
mjj	mawak	Mawak
mjk	matukar	Matukar
mjl	mandeali	Mandeali
mjm	medebur	Medebur
mjn	ma (papua new guinea)	Ma (Papua New Guinea)
mjo	malankuravan	Malankuravan
mjp	malapandaram	Malapandaram
mjq	malaryan	Malaryan
mjr	malavedan	Malavedan
mjs	miship	Miship
mjt	sauria paharia	Sauria Paharia
mju	manna-dora	Manna-Dora
mjv	mannan	Mannan
mjw	karbi	Karbi
mjx	mahali	Mahali
mjy	mahican	Mahican
mjz	majhi	Majhi
mka	mbre	Mbre
mkb	mal paharia	Mal Paharia
mkc	siliput	Siliput
mkd	macédonien	Macédonien
mke	mawchi	Mawchi
mkf	miya	Miya
mkg	mak (china)	Mak (China)
mkh	môn-khmer, langues	Môn-Khmer, Langues
mki	dhatki	Dhatki
mkj	mokilese	Mokilese
mkk	byep	Byep
mkl	mokole	Mokole
mkm	moklen	Moklen
mkn	kupang malay	Kupang Malay
mko	mingang doso	Mingang Doso
mkp	moikodi	Moikodi
mkq	bay miwok	Bay Miwok
mkr	malas	Malas
mks	silacayoapan mixtec	Silacayoapan Mixtec
mkt	vamale	Vamale
mku	konyanka maninka	Konyanka Maninka
mkv	mafea	Mafea
mkw	kituba (congo)	Kituba (Congo)
mkx	kinamiging manobo	Kinamiging Manobo
mky	east makian	East Makian
mkz	makasae	Makasae
mla	malo	Malo
mlb	mbule	Mbule
mlc	cao lan	Cao Lan
mle	manambu	Manambu
mlf	mal	Mal
mlg	malgache	Malgache
mlh	mape	Mape
mli	malimpung	Malimpung
mlj	miltu	Miltu
mlk	ilwana	Ilwana
mll	malua bay	Malua Bay
mlm	mulam	Mulam
mln	malango	Malango
mlo	mlomp	Mlomp
mlp	bargam	Bargam
mlq	western maninkakan	Western Maninkakan
mlr	vame	Vame
mls	masalit	Masalit
mlt	maltais	Maltais
mlu	to'abaita	To'Abaita
mlv	motlav	Motlav
mlw	moloko	Moloko
mlx	malfaxal	Malfaxal
mlz	malaynon	Malaynon
mma	mama	Mama
mmb	momina	Momina
mmc	michoacán mazahua	Michoacán Mazahua
mmd	maonan	Maonan
mme	mae	Mae
mmf	mundat	Mundat
mmg	north ambrym	North Ambrym
mmh	mehináku	Mehináku
mmi	musar	Musar
mmj	majhwar	Majhwar
mmk	mukha-dora	Mukha-Dora
mml	man met	Man Met
mmm	maii	Maii
mmn	mamanwa	Mamanwa
mmo	mangga buang	Mangga Buang
mmp	siawi	Siawi
mmq	musak	Musak
mmr	western xiangxi miao	Western Xiangxi Miao
mmt	malalamai	Malalamai
mmu	mmaala	Mmaala
mmv	miriti	Miriti
mmw	emae	Emae
mmx	madak	Madak
mmy	migaama	Migaama
mmz	mabaale	Mabaale
mna	mbula	Mbula
mnb	muna	Muna
mnc	mandchou	Mandchou
mnd	mondé	Mondé
mne	naba	Naba
mnf	mundani	Mundani
mng	eastern mnong	Eastern Mnong
mnh	mono (democratic republic of congo)	Mono (Democratic Republic Of Congo)
mni	manipuri	Manipuri
mnj	munji	Munji
mnk	mandinka	Mandinka
mnl	tiale	Tiale
mnm	mapena	Mapena
mnn	southern mnong	Southern Mnong
mno	manobo, langues	Manobo, Langues
mnp	min bei chinese	Min Bei Chinese
mnq	minriq	Minriq
mnr	mono (usa)	Mono (Usa)
mns	mansi	Mansi
mnu	mer	Mer
mnv	rennell-bellona	Rennell-Bellona
mnw	mon	Mon
mnx	manikion	Manikion
mny	manyawa	Manyawa
mnz	moni	Moni
moa	mwan	Mwan
moc	mocoví	Mocoví
mod	mobilian	Mobilian
moe	innu	Innu
mog	mongondow	Mongondow
moh	mohawk	Mohawk
moi	mboi	Mboi
moj	monzombo	Monzombo
mok	morori	Morori
mom	mangue	Mangue
moo	monom	Monom
mop	mopán maya	Mopán Maya
moq	mor (bomberai peninsula)	Mor (Bomberai Peninsula)
mor	moro	Moro
mos	moré	Moré
mot	barí	Barí
mou	mogum	Mogum
mov	mohave	Mohave
mow	moi (congo)	Moi (Congo)
mox	molima	Molima
moy	shekkacho	Shekkacho
moz	mukulu	Mukulu
mpa	mpoto	Mpoto
mpb	malak malak	Malak Malak
mpc	mangarrayi	Mangarrayi
mpd	machinere	Machinere
mpe	majang	Majang
mpg	marba	Marba
mph	maung	Maung
mpi	mpade	Mpade
mpj	martu wangka	Martu Wangka
mpk	mbara (chad)	Mbara (Chad)
mpl	middle watut	Middle Watut
mpm	yosondúa mixtec	Yosondúa Mixtec
mpn	mindiri	Mindiri
mpo	miu	Miu
mpp	migabac	Migabac
mpq	matís	Matís
mpr	vangunu	Vangunu
mps	dadibi	Dadibi
mpt	mian	Mian
mpu	makuráp	Makuráp
mpv	mungkip	Mungkip
mpw	mapidian	Mapidian
mpx	misima-panaeati	Misima-Panaeati
mpy	mapia	Mapia
mpz	mpi	Mpi
mqa	maba (indonesia)	Maba (Indonesia)
mqb	mbuko	Mbuko
mqc	mangole	Mangole
mqe	matepi	Matepi
mqf	momuna	Momuna
mqg	kota bangun kutai malay	Kota Bangun Kutai Malay
mqh	tlazoyaltepec mixtec	Tlazoyaltepec Mixtec
mqi	mariri	Mariri
mqj	mamasa	Mamasa
mqk	rajah kabunsuwan manobo	Rajah Kabunsuwan Manobo
mql	mbelime	Mbelime
mqm	marquisien du sud	Marquisien Du Sud
mqn	moronene	Moronene
mqo	modole	Modole
mqp	manipa	Manipa
mqq	minokok	Minokok
mqr	mander	Mander
mqs	west makian	West Makian
mqt	mok	Mok
mqu	mandari	Mandari
mqv	mosimo	Mosimo
mqw	murupi	Murupi
mqx	mamuju	Mamuju
mqy	manggarai	Manggarai
mqz	pano	Pano
mra	mlabri	Mlabri
mrb	marino	Marino
mrc	maricopa	Maricopa
mrd	western magar	Western Magar
mre	martha's vineyard sign language	Martha'S Vineyard Sign Language
mrf	elseng	Elseng
mrg	mising	Mising
mrh	mara chin	Mara Chin
mri	maori	Maori
mrj	western mari	Western Mari
mrk	hmwaveke	Hmwaveke
mrl	mortlockese	Mortlockese
mrm	merlav	Merlav
mrn	cheke holo	Cheke Holo
mro	mru	Mru
mrp	morouas	Morouas
mrq	marquisien du nord	Marquisien Du Nord
mrr	maria (india)	Maria (India)
mrs	maragus	Maragus
mrt	marghi central	Marghi Central
mru	mono (cameroon)	Mono (Cameroon)
mrv	mangarévien	Mangarévien
mrw	maranao	Maranao
mrx	maremgi	Maremgi
mry	mandaya	Mandaya
mrz	marind	Marind
msa	malais (macrolanguage)	Malais (Macrolanguage)
msb	masbatenyo	Masbatenyo
msc	sankaran maninka	Sankaran Maninka
msd	yucatec maya sign language	Yucatec Maya Sign Language
mse	musey	Musey
msf	mekwei	Mekwei
msg	moraid	Moraid
msh	masikoro malagasy	Masikoro Malagasy
msi	sabah malay	Sabah Malay
msj	ma (democratic republic of congo)	Ma (Democratic Republic Of Congo)
msk	mansaka	Mansaka
msl	molof	Molof
msm	agusan manobo	Agusan Manobo
msn	vurës	Vurës
mso	mombum	Mombum
msp	maritsauá	Maritsauá
msq	caac	Caac
msr	mongolian sign language	Mongolian Sign Language
mss	west masela	West Masela
msu	musom	Musom
msv	maslam	Maslam
msw	mansoanka	Mansoanka
msx	moresada	Moresada
msy	aruamu	Aruamu
msz	momare	Momare
mta	cotabato manobo	Cotabato Manobo
mtb	anyin morofo	Anyin Morofo
mtc	munit	Munit
mtd	mualang	Mualang
mte	mono (solomon islands)	Mono (Solomon Islands)
mtf	murik (papua new guinea)	Murik (Papua New Guinea)
mtg	una	Una
mth	munggui	Munggui
mti	maiwa (papua new guinea)	Maiwa (Papua New Guinea)
mtj	moskona	Moskona
mtk	mbe'	Mbe'
mtl	montol	Montol
mtm	mator	Mator
mtn	matagalpa	Matagalpa
mto	totontepec mixe	Totontepec Mixe
mtp	wichí lhamtés nocten	Wichí Lhamtés Nocten
mtq	muong	Muong
mtr	mewari	Mewari
mts	yora	Yora
mtt	mota	Mota
mtu	tututepec mixtec	Tututepec Mixtec
mtv	asaro'o	Asaro'O
mtw	southern binukidnon	Southern Binukidnon
mtx	tidaá mixtec	Tidaá Mixtec
mty	nabi	Nabi
mua	mundang	Mundang
mub	mubi	Mubi
muc	ajumbu	Ajumbu
mud	mednyj aleut	Mednyj Aleut
mue	media lengua	Media Lengua
mug	musgu	Musgu
muh	mündü	Mündü
mui	musi	Musi
muj	mabire	Mabire
muk	mugom	Mugom
mul	multilingue	Multilingue
mum	maiwala	Maiwala
mun	mounda, langues	Mounda, Langues
muo	nyong	Nyong
mup	malvi	Malvi
muq	eastern xiangxi miao	Eastern Xiangxi Miao
mur	murle	Murle
mus	muskogee	Muskogee
mut	western muria	Western Muria
muu	yaaku	Yaaku
muv	muthuvan	Muthuvan
mux	bo-ung	Bo-Ung
muy	muyang	Muyang
muz	mursi	Mursi
mva	manam	Manam
mvb	mattole	Mattole
mvd	mamboru	Mamboru
mve	marwari (pakistan)	Marwari (Pakistan)
mvf	peripheral mongolian	Peripheral Mongolian
mvg	yucuańe mixtec	Yucuańe Mixtec
mvh	mulgi	Mulgi
mvi	miyako	Miyako
mvk	mekmek	Mekmek
mvl	mbara (australia)	Mbara (Australia)
mvn	minaveha	Minaveha
mvo	marovo	Marovo
mvp	duri	Duri
mvq	moere	Moere
mvr	marau	Marau
mvs	massep	Massep
mvt	mpotovoro	Mpotovoro
mvu	marfa	Marfa
mvv	tagal murut	Tagal Murut
mvw	machinga	Machinga
mvx	meoswar	Meoswar
mvy	indus kohistani	Indus Kohistani
mvz	mesqan	Mesqan
mwa	mwatebu	Mwatebu
mwb	juwal	Juwal
mwc	are	Are
mwe	mwera (chimwera)	Mwera (Chimwera)
mwf	murrinh-patha	Murrinh-Patha
mwg	aiklep	Aiklep
mwh	mouk-aria	Mouk-Aria
mwi	labo	Labo
mwk	kita maninkakan	Kita Maninkakan
mwl	mirandais	Mirandais
mwm	sar	Sar
mwn	nyamwanga	Nyamwanga
mwo	central maewo	Central Maewo
mwp	kala lagaw ya	Kala Lagaw Ya
mwq	mün chin	Mün Chin
mwr	marvari	Marvari
mws	mwimbi-muthambi	Mwimbi-Muthambi
mwt	moken	Moken
mwu	mittu	Mittu
mwv	mentawai	Mentawai
mww	hmong daw	Hmong Daw
mwz	moingi	Moingi
mxa	northwest oaxaca mixtec	Northwest Oaxaca Mixtec
mxb	tezoatlán mixtec	Tezoatlán Mixtec
mxc	manyika	Manyika
mxd	modang	Modang
mxe	mele-fila	Mele-Fila
mxf	malgbe	Malgbe
mxg	mbangala	Mbangala
mxh	mvuba	Mvuba
mxi	mozarabic	Mozarabic
mxj	miju-mishmi	Miju-Mishmi
mxk	monumbo	Monumbo
mxl	maxi gbe	Maxi Gbe
mxm	meramera	Meramera
mxn	moi (indonesia)	Moi (Indonesia)
mxo	mbowe	Mbowe
mxp	tlahuitoltepec mixe	Tlahuitoltepec Mixe
mxq	juquila mixe	Juquila Mixe
mxr	murik (malaysia)	Murik (Malaysia)
mxs	huitepec mixtec	Huitepec Mixtec
mxt	jamiltepec mixtec	Jamiltepec Mixtec
mxu	mada (cameroon)	Mada (Cameroon)
mxv	metlatónoc mixtec	Metlatónoc Mixtec
mxw	namo	Namo
mxx	mahou	Mahou
mxy	southeastern nochixtlán mixtec	Southeastern Nochixtlán Mixtec
mxz	central masela	Central Masela
mya	birman	Birman
myb	mbay	Mbay
myc	mayeka	Mayeka
mye	myene	Myene
myf	bambassi	Bambassi
myg	manta	Manta
myh	makah	Makah
myj	mangayat	Mangayat
myk	mamara senoufo	Mamara Senoufo
myl	moma	Moma
mym	me'en	Me'En
myn	maya, langues	Maya, Langues
myo	anfillo	Anfillo
myp	pirahă	Pirahă
myr	muniche	Muniche
mys	mesmes	Mesmes
myu	mundurukú	Mundurukú
myv	erza	Erza
myw	muyuw	Muyuw
myx	masaaba	Masaaba
myy	macuna	Macuna
myz	classical mandaic	Classical Mandaic
mza	santa maría zacatepec mixtec	Santa María Zacatepec Mixtec
mzb	tumzabt	Tumzabt
mzc	madagascar sign language	Madagascar Sign Language
mzd	malimba	Malimba
mze	morawa	Morawa
mzg	monastic sign language	Monastic Sign Language
mzh	wichí lhamtés güisnay	Wichí Lhamtés Güisnay
mzi	ixcatlán mazatec	Ixcatlán Mazatec
mzj	manya	Manya
mzk	nigeria mambila	Nigeria Mambila
mzl	mazatlán mixe	Mazatlán Mixe
mzm	mumuye	Mumuye
mzn	mazanderani	Mazanderani
mzo	matipuhy	Matipuhy
mzp	movima	Movima
mzq	mori atas	Mori Atas
mzr	marúbo	Marúbo
mzs	macanese	Macanese
mzt	mintil	Mintil
mzu	inapang	Inapang
mzv	manza	Manza
mzw	deg	Deg
mzx	mawayana	Mawayana
mzy	mozambican sign language	Mozambican Sign Language
mzz	maiadomu	Maiadomu
naa	namla	Namla
nab	southern nambikuára	Southern Nambikuára
nac	narak	Narak
nae	naka'ela	Naka'Ela
naf	nabak	Nabak
nag	naga pidgin	Naga Pidgin
nah	nahuatl, langues	Nahuatl, Langues
nai	nord-amérindiennes, langues	Nord-Amérindiennes, Langues
naj	nalu	Nalu
nak	nakanai	Nakanai
nal	nalik	Nalik
nam	ngan'gityemerri	Ngan'Gityemerri
nan	min nan chinese	Min Nan Chinese
nao	naaba	Naaba
nap	napolitain	Napolitain
naq	khoekhoe	Khoekhoe
nar	iguta	Iguta
nas	naasioi	Naasioi
nat	cahungwarya	Cahungwarya
nau	nauruan	Nauruan
nav	navaho	Navaho
naw	nawuri	Nawuri
nax	nakwi	Nakwi
nay	ngarrindjeri	Ngarrindjeri
naz	coatepec nahuatl	Coatepec Nahuatl
nba	nyemba	Nyemba
nbb	ndoe	Ndoe
nbc	chang naga	Chang Naga
nbd	ngbinda	Ngbinda
nbe	konyak naga	Konyak Naga
nbg	nagarchal	Nagarchal
nbh	ngamo	Ngamo
nbi	mao naga	Mao Naga
nbj	ngarinyman	Ngarinyman
nbk	nake	Nake
nbl	ndébélé du Sud	Ndébélé Du Sud
nbm	ngbaka ma'bo	Ngbaka Ma'Bo
nbn	kuri	Kuri
nbo	nkukoli	Nkukoli
nbp	nnam	Nnam
nbq	nggem	Nggem
nbr	numana	Numana
nbs	namibian sign language	Namibian Sign Language
nbt	na	Na
nbu	rongmei naga	Rongmei Naga
nbv	ngamambo	Ngamambo
nbw	southern ngbandi	Southern Ngbandi
nby	ningera	Ningera
nca	iyo	Iyo
ncb	central nicobarese	Central Nicobarese
ncc	ponam	Ponam
ncd	nachering	Nachering
nce	yale	Yale
ncf	notsi	Notsi
ncg	nisga'a	Nisga'A
nch	central huasteca nahuatl	Central Huasteca Nahuatl
nci	classical nahuatl	Classical Nahuatl
ncj	northern puebla nahuatl	Northern Puebla Nahuatl
nck	na-kara	Na-Kara
ncl	michoacán nahuatl	Michoacán Nahuatl
ncm	nambo	Nambo
ncn	nauna	Nauna
nco	sibe	Sibe
ncq	northern katang	Northern Katang
ncr	ncane	Ncane
ncs	nicaraguan sign language	Nicaraguan Sign Language
nct	chothe naga	Chothe Naga
ncu	chumburung	Chumburung
ncx	central puebla nahuatl	Central Puebla Nahuatl
ncz	natchez	Natchez
nda	ndasa	Ndasa
ndb	kenswei nsei	Kenswei Nsei
ndc	ndau	Ndau
ndd	nde-nsele-nta	Nde-Nsele-Nta
nde	ndébélé du Nord	Ndébélé Du Nord
ndf	nadruvian	Nadruvian
ndg	ndengereko	Ndengereko
ndh	ndali	Ndali
ndi	samba leko	Samba Leko
ndj	ndamba	Ndamba
ndk	ndaka	Ndaka
ndl	ndolo	Ndolo
ndm	ndam	Ndam
ndn	ngundi	Ngundi
ndo	ndonga	Ndonga
ndp	ndo	Ndo
ndq	ndombe	Ndombe
ndr	ndoola	Ndoola
nds	bas allemand ; bas saxon ; allemand, bas ; saxon, bas	Bas Allemand ; Bas Saxon ; Allemand, Bas ; Saxon, Bas
ndt	ndunga	Ndunga
ndu	dugun	Dugun
ndv	ndut	Ndut
ndw	ndobo	Ndobo
ndx	nduga	Nduga
ndy	lutos	Lutos
ndz	ndogo	Ndogo
nea	eastern ngad'a	Eastern Ngad'A
neb	toura (côte d'ivoire)	Toura (Côte D'Ivoire)
nec	nedebang	Nedebang
ned	nde-gbite	Nde-Gbite
nee	kumak	Kumak
nef	nefamese	Nefamese
neg	negidal	Negidal
neh	nyenkha	Nyenkha
nei	neo-hittite	Neo-Hittite
nej	neko	Neko
nek	neku	Neku
nem	nemi	Nemi
nen	nengone	Nengone
neo	ná-meo	Ná-Meo
nep	népalais	Népalais
neq	north central mixe	North Central Mixe
ner	yahadian	Yahadian
nes	bhoti kinnauri	Bhoti Kinnauri
net	nete	Nete
neu	neo	Neo
nev	nyaheun	Nyaheun
new	nepal bhasa ; newari	Nepal Bhasa ; Newari
nex	neme	Neme
ney	neyo	Neyo
nez	nez perce	Nez Perce
nfa	dhao	Dhao
nfd	ahwai	Ahwai
nfl	ayiwo	Ayiwo
nfr	nafaanra	Nafaanra
nfu	mfumte	Mfumte
nga	ngbaka	Ngbaka
ngb	northern ngbandi	Northern Ngbandi
ngc	ngombe (democratic republic of congo)	Ngombe (Democratic Republic Of Congo)
ngd	ngando (central african republic)	Ngando (Central African Republic)
nge	ngemba	Ngemba
ngg	ngbaka manza	Ngbaka Manza
ngh	n?ng	N?Ng
ngi	ngizim	Ngizim
ngj	ngie	Ngie
ngk	dalabon	Dalabon
ngl	lomwe	Lomwe
ngm	ngatik men's creole	Ngatik Men'S Creole
ngn	ngwo	Ngwo
ngp	ngulu	Ngulu
ngq	ngurimi	Ngurimi
ngr	engdewu	Engdewu
ngs	gvoko	Gvoko
ngt	kriang	Kriang
ngu	guerrero nahuatl	Guerrero Nahuatl
ngv	nagumi	Nagumi
ngw	ngwaba	Ngwaba
ngx	nggwahyi	Nggwahyi
ngy	tibea	Tibea
ngz	ngungwel	Ngungwel
nha	nhanda	Nhanda
nhb	beng	Beng
nhc	tabasco nahuatl	Tabasco Nahuatl
nhd	chiripá	Chiripá
nhe	eastern huasteca nahuatl	Eastern Huasteca Nahuatl
nhf	nhuwala	Nhuwala
nhg	tetelcingo nahuatl	Tetelcingo Nahuatl
nhh	nahari	Nahari
nhi	zacatlán-ahuacatlán-tepetzintla nahuatl	Zacatlán-Ahuacatlán-Tepetzintla Nahuatl
nhk	isthmus-cosoleacaque nahuatl	Isthmus-Cosoleacaque Nahuatl
nhm	morelos nahuatl	Morelos Nahuatl
nhn	central nahuatl	Central Nahuatl
nho	takuu	Takuu
nhp	isthmus-pajapan nahuatl	Isthmus-Pajapan Nahuatl
nhq	huaxcaleca nahuatl	Huaxcaleca Nahuatl
nhr	naro	Naro
nht	ometepec nahuatl	Ometepec Nahuatl
nhu	noone	Noone
nhv	temascaltepec nahuatl	Temascaltepec Nahuatl
nhw	western huasteca nahuatl	Western Huasteca Nahuatl
nhx	isthmus-mecayapan nahuatl	Isthmus-Mecayapan Nahuatl
nhy	northern oaxaca nahuatl	Northern Oaxaca Nahuatl
nhz	santa maría la alta nahuatl	Santa María La Alta Nahuatl
nia	nias	Nias
nib	nakame	Nakame
nic	nigéro-kordofaniennes, langues	Nigéro-Kordofaniennes, Langues
nid	ngandi	Ngandi
nie	niellim	Niellim
nif	nek	Nek
nig	ngalakgan	Ngalakgan
nih	nyiha (tanzania)	Nyiha (Tanzania)
nii	nii	Nii
nij	ngaju	Ngaju
nik	southern nicobarese	Southern Nicobarese
nil	nila	Nila
nim	nilamba	Nilamba
nin	ninzo	Ninzo
nio	nganasan	Nganasan
niq	nandi	Nandi
nir	nimboran	Nimboran
nis	nimi	Nimi
nit	southeastern kolami	Southeastern Kolami
niu	niué	Niué
niv	gilyak	Gilyak
niw	nimo	Nimo
nix	hema	Hema
niy	ngiti	Ngiti
niz	ningil	Ningil
nja	nzanyi	Nzanyi
njb	nocte naga	Nocte Naga
njd	ndonde hamba	Ndonde Hamba
njh	lotha naga	Lotha Naga
nji	gudanji	Gudanji
njj	njen	Njen
njl	njalgulgule	Njalgulgule
njm	angami naga	Angami Naga
njn	liangmai naga	Liangmai Naga
njo	ao naga	Ao Naga
njr	njerep	Njerep
njs	nisa	Nisa
njt	ndyuka-trio pidgin	Ndyuka-Trio Pidgin
nju	ngadjunmaya	Ngadjunmaya
njx	kunyi	Kunyi
njy	njyem	Njyem
njz	nyishi	Nyishi
nka	nkoya	Nkoya
nkb	khoibu naga	Khoibu Naga
nkc	nkongho	Nkongho
nkd	koireng	Koireng
nke	duke	Duke
nkf	inpui naga	Inpui Naga
nkg	nekgini	Nekgini
nkh	khezha naga	Khezha Naga
nki	thangal naga	Thangal Naga
nkj	nakai	Nakai
nkk	nokuku	Nokuku
nkm	namat	Namat
nkn	nkangala	Nkangala
nko	nkonya	Nkonya
nkp	niuatoputapu	Niuatoputapu
nkq	nkami	Nkami
nkr	nukuoro	Nukuoro
nks	north asmat	North Asmat
nkt	nyika (tanzania)	Nyika (Tanzania)
nku	bouna kulango	Bouna Kulango
nkv	nyika (malawi and zambia)	Nyika (Malawi And Zambia)
nkw	nkutu	Nkutu
nkx	nkoroo	Nkoroo
nkz	nkari	Nkari
nla	ngombale	Ngombale
nlc	nalca	Nalca
nld	néerlandais	Néerlandais
nle	east nyala	East Nyala
nlg	gela	Gela
nli	grangali	Grangali
nlj	nyali	Nyali
nlk	ninia yali	Ninia Yali
nll	nihali	Nihali
nlm	mankiyali	Mankiyali
nlo	ngul	Ngul
nlq	lao naga	Lao Naga
nlu	nchumbulu	Nchumbulu
nlv	orizaba nahuatl	Orizaba Nahuatl
nlw	walangama	Walangama
nlx	nahali	Nahali
nly	nyamal	Nyamal
nlz	nalögo	Nalögo
nma	maram naga	Maram Naga
nmb	big nambas	Big Nambas
nmc	ngam	Ngam
nmd	ndumu	Ndumu
nme	mzieme naga	Mzieme Naga
nmf	tangkhul naga (india)	Tangkhul Naga (India)
nmg	kwasio	Kwasio
nmh	monsang naga	Monsang Naga
nmi	nyam	Nyam
nmj	ngombe (central african republic)	Ngombe (Central African Republic)
nmk	namakura	Namakura
nml	ndemli	Ndemli
nmm	manangba	Manangba
nmn	xóő	Xóő
nmo	moyon naga	Moyon Naga
nmp	nimanbur	Nimanbur
nmq	nambya	Nambya
nmr	nimbari	Nimbari
nms	letemboi	Letemboi
nmt	namonuito	Namonuito
nmu	northeast maidu	Northeast Maidu
nmv	ngamini	Ngamini
nmw	nimoa	Nimoa
nmx	nama (papua new guinea)	Nama (Papua New Guinea)
nmy	namuyi	Namuyi
nmz	nawdm	Nawdm
nna	nyangumarta	Nyangumarta
nnb	nande	Nande
nnc	nancere	Nancere
nnd	west ambae	West Ambae
nne	ngandyera	Ngandyera
nnf	ngaing	Ngaing
nng	maring naga	Maring Naga
nnh	ngiemboon	Ngiemboon
nni	north nuaulu	North Nuaulu
nnj	nyangatom	Nyangatom
nnk	nankina	Nankina
nnl	northern rengma naga	Northern Rengma Naga
nnm	namia	Namia
nnn	ngete	Ngete
nno	norvégien nynorsk ; nynorsk, norvégien	Norvégien Nynorsk ; Nynorsk, Norvégien
nnp	wancho naga	Wancho Naga
nnq	ngindo	Ngindo
nnr	narungga	Narungga
nnt	nanticoke	Nanticoke
nnu	dwang	Dwang
nnv	nugunu (australia)	Nugunu (Australia)
nnw	southern nuni	Southern Nuni
nny	nyangga	Nyangga
nnz	nda'nda'	Nda'Nda'
noa	woun meu	Woun Meu
nob	norvégien bokmĺl ; bokmĺl norvégien	Norvégien Bokmĺl ; Bokmĺl Norvégien
noc	nuk	Nuk
nod	northern thai	Northern Thai
noe	nimadi	Nimadi
nof	nomane	Nomane
nog	nogaï ; nogay	Nogaï ; Nogay
noh	nomu	Nomu
noi	noiri	Noiri
noj	nonuya	Nonuya
nok	nooksack	Nooksack
nol	nomlaki	Nomlaki
nom	nocamán	Nocamán
non	norrois, vieux	Norrois, Vieux
nop	numanggang	Numanggang
noq	ngongo	Ngongo
nor	norvégien	Norvégien
nos	eastern nisu	Eastern Nisu
not	nomatsiguenga	Nomatsiguenga
nou	ewage-notu	Ewage-Notu
nov	novial	Novial
now	nyambo	Nyambo
noy	noy	Noy
noz	nayi	Nayi
npa	nar phu	Nar Phu
npb	nupbikha	Nupbikha
npg	ponyo-gongwang naga	Ponyo-Gongwang Naga
nph	phom naga	Phom Naga
npi	nepali (individual language)	Nepali (Individual Language)
npl	southeastern puebla nahuatl	Southeastern Puebla Nahuatl
npn	mondropolon	Mondropolon
npo	pochuri naga	Pochuri Naga
nps	nipsan	Nipsan
npu	puimei naga	Puimei Naga
npx	noipx	Noipx
npy	napu	Napu
nqg	southern nago	Southern Nago
nqk	kura ede nago	Kura Ede Nago
nql	ngendelengo	Ngendelengo
nqm	ndom	Ndom
nqn	nen	Nen
nqo	n'ko	N'Ko
nqq	kyan-karyaw naga	Kyan-Karyaw Naga
nqt	nteng	Nteng
nqy	akyaung ari naga	Akyaung Ari Naga
nra	ngom	Ngom
nrb	nara	Nara
nrc	noric	Noric
nre	southern rengma naga	Southern Rengma Naga
nrf	normand	Normand
nrg	narango	Narango
nri	chokri naga	Chokri Naga
nrk	ngarla	Ngarla
nrl	ngarluma	Ngarluma
nrm	narom	Narom
nrn	norn	Norn
nrp	north picene	North Picene
nrr	norra	Norra
nrt	northern kalapuya	Northern Kalapuya
nru	narua	Narua
nrx	ngurmbur	Ngurmbur
nrz	lala	Lala
nsa	sangtam naga	Sangtam Naga
nsb	lower nossob	Lower Nossob
nsc	nshi	Nshi
nsd	southern nisu	Southern Nisu
nse	nsenga	Nsenga
nsf	northwestern nisu	Northwestern Nisu
nsg	ngasa	Ngasa
nsh	ngoshie	Ngoshie
nsi	nigerian sign language	Nigerian Sign Language
nsk	naskapi	Naskapi
nsl	norwegian sign language	Norwegian Sign Language
nsm	sumi naga	Sumi Naga
nsn	nehan	Nehan
nso	pedi ; sepedi ; sotho du Nord	Pedi ; Sepedi ; Sotho Du Nord
nsp	nepalese sign language	Nepalese Sign Language
nsq	northern sierra miwok	Northern Sierra Miwok
nsr	maritime sign language	Maritime Sign Language
nss	nali	Nali
nst	tase naga	Tase Naga
nsu	sierra negra nahuatl	Sierra Negra Nahuatl
nsv	southwestern nisu	Southwestern Nisu
nsw	navut	Navut
nsx	nsongo	Nsongo
nsy	nasal	Nasal
nsz	nisenan	Nisenan
ntd	northern tidung	Northern Tidung
nte	nathembo	Nathembo
ntg	ngantangarra	Ngantangarra
nti	natioro	Natioro
ntj	ngaanyatjarra	Ngaanyatjarra
ntk	ikoma-nata-isenye	Ikoma-Nata-Isenye
ntm	nateni	Nateni
nto	ntomba	Ntomba
ntp	northern tepehuan	Northern Tepehuan
ntr	delo	Delo
ntu	natügu	Natügu
ntw	nottoway	Nottoway
ntx	tangkhul naga (myanmar)	Tangkhul Naga (Myanmar)
nty	mantsi	Mantsi
ntz	natanzi	Natanzi
nua	yuaga	Yuaga
nub	nubiennes, langues	Nubiennes, Langues
nuc	nukuini	Nukuini
nud	ngala	Ngala
nue	ngundu	Ngundu
nuf	nusu	Nusu
nug	nungali	Nungali
nuh	ndunda	Ndunda
nui	ngumbi	Ngumbi
nuj	nyole	Nyole
nuk	nuu-chah-nulth	Nuu-Chah-Nulth
nul	nusa laut	Nusa Laut
num	niuafo'ou	Niuafo'Ou
nun	anong	Anong
nuo	nguôn	Nguôn
nup	nupe-nupe-tako	Nupe-Nupe-Tako
nuq	nukumanu	Nukumanu
nur	nukuria	Nukuria
nus	nuer	Nuer
nut	nung (viet nam)	Nung (Viet Nam)
nuu	ngbundu	Ngbundu
nuv	northern nuni	Northern Nuni
nuw	nguluwan	Nguluwan
nux	mehek	Mehek
nuy	nunggubuyu	Nunggubuyu
nuz	tlamacazapa nahuatl	Tlamacazapa Nahuatl
nvh	nasarian	Nasarian
nvm	namiae	Namiae
nvo	nyokon	Nyokon
nwa	nawathinehena	Nawathinehena
nwb	nyabwa	Nyabwa
nwc	newari classique	Newari Classique
nwe	ngwe	Ngwe
nwg	ngayawung	Ngayawung
nwi	southwest tanna	Southwest Tanna
nwm	nyamusa-molo	Nyamusa-Molo
nwo	nauo	Nauo
nwr	nawaru	Nawaru
nww	ndwewe	Ndwewe
nwx	middle newar	Middle Newar
nwy	nottoway-meherrin	Nottoway-Meherrin
nxa	nauete	Nauete
nxd	ngando (democratic republic of congo)	Ngando (Democratic Republic Of Congo)
nxe	nage	Nage
nxg	ngad'a	Ngad'A
nxi	nindi	Nindi
nxk	koki naga	Koki Naga
nxl	south nuaulu	South Nuaulu
nxm	numidian	Numidian
nxn	ngawun	Ngawun
nxo	ndambomo	Ndambomo
nxq	naxi	Naxi
nxr	ninggerum	Ninggerum
nxx	nafri	Nafri
nya	chichewa ; chewa; nyanja	Chichewa ; Chewa; Nyanja
nyb	nyangbo	Nyangbo
nyc	nyanga-li	Nyanga-Li
nyd	nyore	Nyore
nye	nyengo	Nyengo
nyf	giryama	Giryama
nyg	nyindu	Nyindu
nyh	nyikina	Nyikina
nyi	ama (sudan)	Ama (Sudan)
nyj	nyanga	Nyanga
nyk	nyaneka	Nyaneka
nyl	nyeu	Nyeu
nym	nyamwezi	Nyamwezi
nyn	nyankolé	Nyankolé
nyo	nyoro	Nyoro
nyp	nyang'i	Nyang'I
nyq	nayini	Nayini
nyr	nyiha (malawi)	Nyiha (Malawi)
nys	nyungar	Nyungar
nyt	nyawaygi	Nyawaygi
nyu	nyungwe	Nyungwe
nyv	nyulnyul	Nyulnyul
nyw	nyaw	Nyaw
nyx	nganyaywana	Nganyaywana
nyy	nyakyusa-ngonde	Nyakyusa-Ngonde
nza	tigon mbembe	Tigon Mbembe
nzb	njebi	Njebi
nzd	nzadi	Nzadi
nzi	nzema	Nzema
nzk	nzakara	Nzakara
nzm	zeme naga	Zeme Naga
nzs	new zealand sign language	New Zealand Sign Language
nzu	teke-nzikou	Teke-Nzikou
nzy	nzakambay	Nzakambay
nzz	nanga dama dogon	Nanga Dama Dogon
oaa	orok	Orok
oac	oroch	Oroch
oar	old aramaic (up to 700 bce)	Old Aramaic (Up To 700 Bce)
oav	old avar	Old Avar
obi	obispeńo	Obispeńo
obk	southern bontok	Southern Bontok
obl	oblo	Oblo
obm	moabite	Moabite
obo	obo manobo	Obo Manobo
obr	old burmese	Old Burmese
obt	old breton	Old Breton
obu	obulom	Obulom
oca	ocaina	Ocaina
och	old chinese	Old Chinese
oci	occitan (après 1500)	Occitan (Après 1500)
ocm	old cham	Old Cham
oco	old cornish	Old Cornish
ocu	atzingo matlatzinca	Atzingo Matlatzinca
oda	odut	Odut
odk	od	Od
odt	old dutch	Old Dutch
odu	odual	Odual
ofo	ofo	Ofo
ofs	old frisian	Old Frisian
ofu	efutop	Efutop
ogb	ogbia	Ogbia
ogc	ogbah	Ogbah
oge	old georgian	Old Georgian
ogg	ogbogolo	Ogbogolo
ogo	khana	Khana
ogu	ogbronuagum	Ogbronuagum
oht	old hittite	Old Hittite
ohu	old hungarian	Old Hungarian
oia	oirata	Oirata
oie	okolie	Okolie
oin	inebu one	Inebu One
ojb	northwestern ojibwa	Northwestern Ojibwa
ojc	central ojibwa	Central Ojibwa
ojg	eastern ojibwa	Eastern Ojibwa
oji	ojibwa	Ojibwa
ojp	old japanese	Old Japanese
ojs	severn ojibwa	Severn Ojibwa
ojv	ontong java	Ontong Java
ojw	western ojibwa	Western Ojibwa
oka	okanagan	Okanagan
okb	okobo	Okobo
okc	kobo	Kobo
okd	okodia	Okodia
oke	okpe (southwestern edo)	Okpe (Southwestern Edo)
okg	koko babangk	Koko Babangk
okh	koresh-e rostam	Koresh-E Rostam
oki	okiek	Okiek
okj	oko-juwoi	Oko-Juwoi
okk	kwamtim one	Kwamtim One
okl	old kentish sign language	Old Kentish Sign Language
okm	middle korean (10th-16th cent.)	Middle Korean (10Th-16Th Cent.)
okn	oki-no-erabu	Oki-No-Erabu
oko	old korean (3rd-9th cent.)	Old Korean (3Rd-9Th Cent.)
okr	kirike	Kirike
oks	oko-eni-osayen	Oko-Eni-Osayen
oku	oku	Oku
okv	orokaiva	Orokaiva
okx	okpe (northwestern edo)	Okpe (Northwestern Edo)
okz	old khmer	Old Khmer
ola	walungge	Walungge
old	mochi	Mochi
ole	olekha	Olekha
olk	olkol	Olkol
olm	oloma	Oloma
olo	livvi	Livvi
olr	olrat	Olrat
olt	old lithuanian	Old Lithuanian
olu	kuvale	Kuvale
oma	omaha-ponca	Omaha-Ponca
omb	east ambae	East Ambae
omc	mochica	Mochica
omg	omagua	Omagua
omi	omi	Omi
omk	omok	Omok
oml	ombo	Ombo
omn	minoan	Minoan
omo	utarmbung	Utarmbung
omp	old manipuri	Old Manipuri
omr	old marathi	Old Marathi
omt	omotik	Omotik
omu	omurano	Omurano
omw	south tairora	South Tairora
omx	old mon	Old Mon
omy	old malay	Old Malay
ona	ona	Ona
onb	lingao	Lingao
one	oneida	Oneida
ong	olo	Olo
oni	onin	Onin
onj	onjob	Onjob
onk	kabore one	Kabore One
onn	onobasulu	Onobasulu
ono	onondaga	Onondaga
onp	sartang	Sartang
onr	northern one	Northern One
ons	ono	Ono
ont	ontenu	Ontenu
onu	unua	Unua
onw	old nubian	Old Nubian
onx	onin based pidgin	Onin Based Pidgin
ood	tohono o'odham	Tohono O'Odham
oog	ong	Ong
oon	önge	Önge
oor	oorlams	Oorlams
oos	old ossetic	Old Ossetic
opa	okpamheri	Okpamheri
opk	kopkaka	Kopkaka
opm	oksapmin	Oksapmin
opo	opao	Opao
opt	opata	Opata
opy	ofayé	Ofayé
ora	oroha	Oroha
orc	orma	Orma
ore	orejón	Orejón
org	oring	Oring
orh	oroqen	Oroqen
ori	oriya	Oriya
orm	galla	Galla
orn	orang kanaq	Orang Kanaq
oro	orokolo	Orokolo
orr	oruma	Oruma
ors	orang seletar	Orang Seletar
ort	adivasi oriya	Adivasi Oriya
oru	ormuri	Ormuri
orv	old russian	Old Russian
orw	oro win	Oro Win
orx	oro	Oro
ory	odia	Odia
orz	ormu	Ormu
osa	osage	Osage
osc	oscan	Oscan
osi	osing	Osing
osn	old sundanese	Old Sundanese
oso	ososo	Ososo
osp	old spanish	Old Spanish
oss	osséte	Osséte
ost	osatu	Osatu
osu	southern one	Southern One
osx	old saxon	Old Saxon
ota	turc ottoman (1500-1928)	Turc Ottoman (1500-1928)
otb	old tibetan	Old Tibetan
otd	ot danum	Ot Danum
ote	mezquital otomi	Mezquital Otomi
oti	oti	Oti
otk	old turkish	Old Turkish
otl	tilapa otomi	Tilapa Otomi
otm	eastern highland otomi	Eastern Highland Otomi
otn	tenango otomi	Tenango Otomi
oto	otomi, langues	Otomi, Langues
otq	querétaro otomi	Querétaro Otomi
otr	otoro	Otoro
ots	estado de méxico otomi	Estado De México Otomi
ott	temoaya otomi	Temoaya Otomi
otu	otuke	Otuke
otw	ottawa	Ottawa
otx	texcatepec otomi	Texcatepec Otomi
oty	old tamil	Old Tamil
otz	ixtenco otomi	Ixtenco Otomi
oua	tagargrent	Tagargrent
oub	glio-oubi	Glio-Oubi
oue	oune	Oune
oui	old uighur	Old Uighur
oum	ouma	Ouma
ovd	elfdalian	Elfdalian
owi	owiniga	Owiniga
owl	old welsh	Old Welsh
oyb	oy	Oy
oyd	oyda	Oyda
oym	wayampi	Wayampi
oyy	oya'oya	Oya'Oya
ozm	koonzime	Koonzime
paa	papoues (autres langues)	Papoues (Autres Langues)
pab	parecís	Parecís
pac	pacoh	Pacoh
pad	paumarí	Paumarí
pae	pagibete	Pagibete
paf	paranawát	Paranawát
pag	pangasinan	Pangasinan
pah	tenharim	Tenharim
pai	pe	Pe
pak	parakană	Parakană
pal	pahlavi	Pahlavi
pam	pampangan	Pampangan
pan	pendjabi	Pendjabi
pao	northern paiute	Northern Paiute
pap	papiamento	Papiamento
paq	parya	Parya
par	panamint	Panamint
pas	papasena	Papasena
pau	palau	Palau
pav	pakaásnovos	Pakaásnovos
paw	pawnee	Pawnee
pax	pankararé	Pankararé
pay	pech	Pech
paz	pankararú	Pankararú
pbb	páez	Páez
pbc	patamona	Patamona
pbe	mezontla popoloca	Mezontla Popoloca
pbf	coyotepec popoloca	Coyotepec Popoloca
pbg	paraujano	Paraujano
pbh	e'ńapa woromaipu	E'Ńapa Woromaipu
pbi	parkwa	Parkwa
pbl	mak (nigeria)	Mak (Nigeria)
pbm	puebla mazatec	Puebla Mazatec
pbn	kpasam	Kpasam
pbo	papel	Papel
pbp	badyara	Badyara
pbr	pangwa	Pangwa
pbs	central pame	Central Pame
pbt	southern pashto	Southern Pashto
pbu	northern pashto	Northern Pashto
pbv	pnar	Pnar
pby	pyu (papua new guinea)	Pyu (Papua New Guinea)
pca	santa inés ahuatempan popoloca	Santa Inés Ahuatempan Popoloca
pcb	pear	Pear
pcc	bouyei	Bouyei
pcd	picard	Picard
pce	ruching palaung	Ruching Palaung
pcf	paliyan	Paliyan
pcg	paniya	Paniya
pch	pardhan	Pardhan
pci	duruwa	Duruwa
pcj	parenga	Parenga
pck	paite chin	Paite Chin
pcl	pardhi	Pardhi
pcm	nigerian pidgin	Nigerian Pidgin
pcn	piti	Piti
pcp	pacahuara	Pacahuara
pcw	pyapun	Pyapun
pda	anam	Anam
pdc	pennsylvania german	Pennsylvania German
pdi	pa di	Pa Di
pdn	podena	Podena
pdo	padoe	Padoe
pdt	plautdietsch	Plautdietsch
pdu	kayan	Kayan
pea	peranakan indonesian	Peranakan Indonesian
peb	eastern pomo	Eastern Pomo
ped	mala (papua new guinea)	Mala (Papua New Guinea)
pee	taje	Taje
pef	northeastern pomo	Northeastern Pomo
peg	pengo	Pengo
peh	bonan	Bonan
pei	chichimeca-jonaz	Chichimeca-Jonaz
pej	northern pomo	Northern Pomo
pek	penchal	Penchal
pel	pekal	Pekal
pem	phende	Phende
peo	perse, vieux (ca. 600-400 av J.-C.)	Perse, Vieux (Ca. 600-400 Av J.-C.)
pep	kunja	Kunja
peq	southern pomo	Southern Pomo
pes	iranian persian	Iranian Persian
pev	pémono	Pémono
pex	petats	Petats
pey	petjo	Petjo
pez	eastern penan	Eastern Penan
pfa	pááfang	Pááfang
pfe	pere	Pere
pfl	pfaelzisch	Pfaelzisch
pga	sudanese creole arabic	Sudanese Creole Arabic
pgd	gandhari	Gandhari
pgg	pangwali	Pangwali
pgi	pagi	Pagi
pgk	rerep	Rerep
pgl	primitive irish	Primitive Irish
pgn	paelignian	Paelignian
pgs	pangseng	Pangseng
pgu	pagu	Pagu
pgz	papua new guinean sign language	Papua New Guinean Sign Language
pha	pa-hng	Pa-Hng
phd	phudagi	Phudagi
phg	phuong	Phuong
phh	phukha	Phukha
phi	philippines, langues)	Philippines, Langues)
phj	pahari	Pahari
phk	phake	Phake
phl	phalura	Phalura
phm	phimbi	Phimbi
phn	phénicien	Phénicien
pho	phunoi	Phunoi
phq	phana'	Phana'
phr	pahari-potwari	Pahari-Potwari
pht	phu thai	Phu Thai
phu	phuan	Phuan
phv	pahlavani	Pahlavani
phw	phangduwali	Phangduwali
pia	pima bajo	Pima Bajo
pib	yine	Yine
pic	pinji	Pinji
pid	piaroa	Piaroa
pie	piro	Piro
pif	pingelapese	Pingelapese
pig	pisabo	Pisabo
pih	pitcairn-norfolk	Pitcairn-Norfolk
pij	pijao	Pijao
pil	yom	Yom
pim	powhatan	Powhatan
pin	piame	Piame
pio	piapoco	Piapoco
pip	pero	Pero
pir	piratapuyo	Piratapuyo
pis	pijin	Pijin
pit	pitta pitta	Pitta Pitta
piu	pintupi-luritja	Pintupi-Luritja
piv	pileni	Pileni
piw	pimbwe	Pimbwe
pix	piu	Piu
piy	piya-kwonci	Piya-Kwonci
piz	pije	Pije
pjt	pitjantjatjara	Pitjantjatjara
pka	ardhamagadhi prakrit	Ardhamagadhi Prakrit
pkb	pokomo	Pokomo
pkc	paekche	Paekche
pkg	pak-tong	Pak-Tong
pkh	pankhu	Pankhu
pkn	pakanha	Pakanha
pko	pökoot	Pökoot
pkp	pukapuka	Pukapuka
pkr	attapady kurumba	Attapady Kurumba
pks	pakistan sign language	Pakistan Sign Language
pkt	maleng	Maleng
pku	paku	Paku
pla	miani	Miani
plb	polonombauk	Polonombauk
plc	central palawano	Central Palawano
pld	polari	Polari
ple	palu'e	Palu'E
plg	pilagá	Pilagá
plh	paulohi	Paulohi
pli	pali	Pali
plj	polci	Polci
plk	kohistani shina	Kohistani Shina
pll	shwe palaung	Shwe Palaung
pln	palenquero	Palenquero
plo	oluta popoluca	Oluta Popoluca
plq	palaic	Palaic
plr	palaka senoufo	Palaka Senoufo
pls	san marcos tlacoyalco popoloca	San Marcos Tlacoyalco Popoloca
plt	plateau malagasy	Plateau Malagasy
plu	palikúr	Palikúr
plv	southwest palawano	Southwest Palawano
plw	brooke's point palawano	Brooke'S Point Palawano
ply	bolyu	Bolyu
plz	paluan	Paluan
pma	paama	Paama
pmb	pambia	Pambia
pmd	pallanganmiddang	Pallanganmiddang
pme	pwaamei	Pwaamei
pmf	pamona	Pamona
pmh	maharastri prakrit	Maharastri Prakrit
pmi	northern pumi	Northern Pumi
pmj	southern pumi	Southern Pumi
pmk	pamlico	Pamlico
pml	lingua franca	Lingua Franca
pmm	pomo	Pomo
pmn	pam	Pam
pmo	pom	Pom
pmq	northern pame	Northern Pame
pmr	paynamar	Paynamar
pms	piemontese	Piemontese
pmt	paumotu	Paumotu
pmw	plains miwok	Plains Miwok
pmx	poumei naga	Poumei Naga
pmy	papuan malay	Papuan Malay
pmz	southern pame	Southern Pame
pna	punan bah-biau	Punan Bah-Biau
pnb	western panjabi	Western Panjabi
pnc	pannei	Pannei
pnd	mpinda	Mpinda
pne	western penan	Western Penan
png	pangu	Pangu
pnh	penrhyn	Penrhyn
pni	aoheng	Aoheng
pnj	pinjarup	Pinjarup
pnk	paunaka	Paunaka
pnl	paleni	Paleni
pnm	punan batu 1	Punan Batu 1
pnn	pinai-hagahai	Pinai-Hagahai
pno	panobo	Panobo
pnp	pancana	Pancana
pnq	pana (burkina faso)	Pana (Burkina Faso)
pnr	panim	Panim
pns	ponosakan	Ponosakan
pnt	pontic	Pontic
pnu	jiongnai bunu	Jiongnai Bunu
pnv	pinigura	Pinigura
pnw	banyjima	Banyjima
pnx	phong-kniang	Phong-Kniang
pny	pinyin	Pinyin
pnz	pana (central african republic)	Pana (Central African Republic)
poc	poqomam	Poqomam
poe	san juan atzingo popoloca	San Juan Atzingo Popoloca
pof	poke	Poke
pog	potiguára	Potiguára
poh	poqomchi'	Poqomchi'
poi	highland popoluca	Highland Popoluca
pok	pokangá	Pokangá
pol	polonais	Polonais
pom	southeastern pomo	Southeastern Pomo
pon	pohnpei	Pohnpei
poo	central pomo	Central Pomo
pop	pwapwà	Pwapwà
poq	texistepec popoluca	Texistepec Popoluca
por	portugais	Portugais
pos	sayula popoluca	Sayula Popoluca
pot	potawatomi	Potawatomi
pov	upper guinea crioulo	Upper Guinea Crioulo
pow	san felipe otlaltepec popoloca	San Felipe Otlaltepec Popoloca
pox	polabian	Polabian
poy	pogolo	Pogolo
ppe	papi	Papi
ppi	paipai	Paipai
ppk	uma	Uma
ppl	pipil	Pipil
ppm	papuma	Papuma
ppn	papapana	Papapana
ppo	folopa	Folopa
ppp	pelende	Pelende
ppq	pei	Pei
pps	san luís temalacayuca popoloca	San Luís Temalacayuca Popoloca
ppt	pare	Pare
ppu	papora	Papora
pqa	pa'a	Pa'A
pqm	malecite-passamaquoddy	Malecite-Passamaquoddy
pra	pràkrit, langues	Pràkrit, Langues
prc	parachi	Parachi
prd	parsi-dari	Parsi-Dari
pre	principense	Principense
prf	paranan	Paranan
prg	prussian	Prussian
prh	porohanon	Porohanon
pri	paicî	Paicî
prk	parauk	Parauk
prl	peruvian sign language	Peruvian Sign Language
prm	kibiri	Kibiri
prn	prasuni	Prasuni
pro	provençal ancien (jusqu'à 1500) ; occitan ancien (jusqu'à 1500)	Provençal Ancien (Jusqu'À 1500) ; Occitan Ancien (Jusqu'À 1500)
oci	provençal	Provençal
prp	parsi	Parsi
prq	ashéninka perené	Ashéninka Perené
prr	puri	Puri
prs	dari	Dari
prt	phai	Phai
pru	puragi	Puragi
prw	parawen	Parawen
prx	purik	Purik
prz	providencia sign language	Providencia Sign Language
psa	asue awyu	Asue Awyu
psc	iranian sign language	Iranian Sign Language
psd	plains indian sign language	Plains Indian Sign Language
pse	central malay	Central Malay
psg	penang sign language	Penang Sign Language
psh	southwest pashai	Southwest Pashai
psi	southeast pashai	Southeast Pashai
psl	puerto rican sign language	Puerto Rican Sign Language
psm	pauserna	Pauserna
psn	panasuan	Panasuan
pso	polish sign language	Polish Sign Language
psp	philippine sign language	Philippine Sign Language
psq	pasi	Pasi
psr	portuguese sign language	Portuguese Sign Language
pss	kaulong	Kaulong
pst	central pashto	Central Pashto
psu	sauraseni prakrit	Sauraseni Prakrit
psw	port sandwich	Port Sandwich
psy	piscataway	Piscataway
pta	pai tavytera	Pai Tavytera
pth	pataxó hă-ha-hăe	Pataxó Hă-Ha-Hăe
pti	pindiini	Pindiini
ptn	patani	Patani
pto	zo'é	Zo'É
ptp	patep	Patep
ptq	pattapu	Pattapu
ptr	piamatsina	Piamatsina
ptt	enrekang	Enrekang
ptu	bambam	Bambam
ptv	port vato	Port Vato
ptw	pentlatch	Pentlatch
pty	pathiya	Pathiya
pua	western highland purepecha	Western Highland Purepecha
pub	purum	Purum
puc	punan merap	Punan Merap
pud	punan aput	Punan Aput
pue	puelche	Puelche
puf	punan merah	Punan Merah
pug	phuie	Phuie
pui	puinave	Puinave
puj	punan tubu	Punan Tubu
pum	puma	Puma
puo	puoc	Puoc
pup	pulabu	Pulabu
puq	puquina	Puquina
pur	puruborá	Puruborá
pus	pachto	Pachto
put	putoh	Putoh
puu	punu	Punu
puw	puluwatese	Puluwatese
pux	puare	Puare
puy	purisimeńo	Purisimeńo
pwa	pawaia	Pawaia
pwb	panawa	Panawa
pwg	gapapaiwa	Gapapaiwa
pwi	patwin	Patwin
pwm	molbog	Molbog
pwn	paiwan	Paiwan
pwo	pwo western karen	Pwo Western Karen
pwr	powari	Powari
pww	pwo northern karen	Pwo Northern Karen
pxm	quetzaltepec mixe	Quetzaltepec Mixe
pye	pye krumen	Pye Krumen
pym	fyam	Fyam
pyn	poyanáwa	Poyanáwa
pys	paraguayan sign language	Paraguayan Sign Language
pyu	puyuma	Puyuma
pyx	pyu (myanmar)	Pyu (Myanmar)
pyy	pyen	Pyen
pzh	pazeh	Pazeh
pzn	jejara naga	Jejara Naga
qua	quapaw	Quapaw
qub	huallaga huánuco quechua	Huallaga Huánuco Quechua
quc	k'iche'	K'Iche'
qud	calderón highland quichua	Calderón Highland Quichua
que	quechua	Quechua
quf	lambayeque quechua	Lambayeque Quechua
qug	chimborazo highland quichua	Chimborazo Highland Quichua
quh	south bolivian quechua	South Bolivian Quechua
qui	quileute	Quileute
quk	chachapoyas quechua	Chachapoyas Quechua
qul	north bolivian quechua	North Bolivian Quechua
qum	sipacapense	Sipacapense
qun	quinault	Quinault
qup	southern pastaza quechua	Southern Pastaza Quechua
quq	quinqui	Quinqui
qur	yanahuanca pasco quechua	Yanahuanca Pasco Quechua
qus	santiago del estero quichua	Santiago Del Estero Quichua
quv	sacapulteco	Sacapulteco
quw	tena lowland quichua	Tena Lowland Quichua
qux	yauyos quechua	Yauyos Quechua
quy	ayacucho quechua	Ayacucho Quechua
quz	cusco quechua	Cusco Quechua
qva	ambo-pasco quechua	Ambo-Pasco Quechua
qvc	cajamarca quechua	Cajamarca Quechua
qve	eastern apurímac quechua	Eastern Apurímac Quechua
qvh	huamalíes-dos de mayo huánuco quechua	Huamalíes-Dos De Mayo Huánuco Quechua
qvi	imbabura highland quichua	Imbabura Highland Quichua
qvj	loja highland quichua	Loja Highland Quichua
qvl	cajatambo north lima quechua	Cajatambo North Lima Quechua
qvm	margos-yarowilca-lauricocha quechua	Margos-Yarowilca-Lauricocha Quechua
qvn	north junín quechua	North Junín Quechua
qvo	napo lowland quechua	Napo Lowland Quechua
qvp	pacaraos quechua	Pacaraos Quechua
qvs	san martín quechua	San Martín Quechua
qvw	huaylla wanca quechua	Huaylla Wanca Quechua
qvy	queyu	Queyu
qvz	northern pastaza quichua	Northern Pastaza Quichua
qwa	corongo ancash quechua	Corongo Ancash Quechua
qwc	classical quechua	Classical Quechua
qwh	huaylas ancash quechua	Huaylas Ancash Quechua
qwm	kuman (russia)	Kuman (Russia)
qws	sihuas ancash quechua	Sihuas Ancash Quechua
qwt	kwalhioqua-tlatskanai	Kwalhioqua-Tlatskanai
qxa	chiquián ancash quechua	Chiquián Ancash Quechua
qxc	chincha quechua	Chincha Quechua
qxh	panao huánuco quechua	Panao Huánuco Quechua
qxl	salasaca highland quichua	Salasaca Highland Quichua
qxn	northern conchucos ancash quechua	Northern Conchucos Ancash Quechua
qxo	southern conchucos ancash quechua	Southern Conchucos Ancash Quechua
qxp	puno quechua	Puno Quechua
qxq	qashqa'i	Qashqa'I
qxr	cańar highland quichua	Cańar Highland Quichua
qxs	southern qiang	Southern Qiang
qxt	santa ana de tusi pasco quechua	Santa Ana De Tusi Pasco Quechua
qxu	arequipa-la unión quechua	Arequipa-La Unión Quechua
qxw	jauja wanca quechua	Jauja Wanca Quechua
qya	quenya	Quenya
qyp	quiripi	Quiripi
raa	dungmali	Dungmali
rab	camling	Camling
rac	rasawa	Rasawa
rad	rade	Rade
raf	western meohang	Western Meohang
rag	logooli	Logooli
rah	rabha	Rabha
rai	ramoaaina	Ramoaaina
raj	rajasthani	Rajasthani
rak	tulu-bohuai	Tulu-Bohuai
ral	ralte	Ralte
ram	canela	Canela
ran	riantana	Riantana
rao	rao	Rao
rap	rapanui	Rapanui
raq	saam	Saam
rar	rarotonga ; maori des îles Cook	Rarotonga ; Maori Des Îles Cook
ras	tegali	Tegali
rat	razajerdi	Razajerdi
rau	raute	Raute
rav	sampang	Sampang
raw	rawang	Rawang
rax	rang	Rang
ray	rapa	Rapa
raz	rahambuu	Rahambuu
rbb	rumai palaung	Rumai Palaung
rbk	northern bontok	Northern Bontok
rbl	miraya bikol	Miraya Bikol
rbp	barababaraba	Barababaraba
rcf	créole réunionnais	Créole Réunionnais
rdb	rudbari	Rudbari
rea	rerau	Rerau
reb	rembong	Rembong
ree	rejang kayan	Rejang Kayan
reg	kara (tanzania)	Kara (Tanzania)
rei	reli	Reli
rej	rejang	Rejang
rel	rendille	Rendille
rem	remo	Remo
ren	rengao	Rengao
rer	rer bare	Rer Bare
res	reshe	Reshe
ret	retta	Retta
rey	reyesano	Reyesano
rga	roria	Roria
rge	romano-greek	Romano-Greek
rgk	rangkas	Rangkas
rgn	romagnol	Romagnol
rgr	resígaro	Resígaro
rgs	southern roglai	Southern Roglai
rgu	ringgou	Ringgou
rhg	rohingya	Rohingya
rhp	yahang	Yahang
ria	riang (india)	Riang (India)
rib	bribri sign language	Bribri Sign Language
rif	tarifit	Tarifit
ril	riang lang	Riang Lang
rim	nyaturu	Nyaturu
rin	nungu	Nungu
rir	ribun	Ribun
rit	ritharrngu	Ritharrngu
riu	riung	Riung
rjg	rajong	Rajong
rji	raji	Raji
rjs	rajbanshi	Rajbanshi
rka	kraol	Kraol
rkb	rikbaktsa	Rikbaktsa
rkh	rakahanga-manihiki	Rakahanga-Manihiki
rki	rakhine	Rakhine
rkm	marka	Marka
rkt	rangpuri	Rangpuri
rkw	arakwal	Arakwal
rma	rama	Rama
rmb	rembarrnga	Rembarrnga
rmc	carpathian romani	Carpathian Romani
rmd	traveller danish	Traveller Danish
rme	angloromani	Angloromani
rmf	kalo finnish romani	Kalo Finnish Romani
rmg	traveller norwegian	Traveller Norwegian
rmh	murkim	Murkim
rmi	lomavren	Lomavren
rmk	romkun	Romkun
rml	baltic romani	Baltic Romani
rmm	roma	Roma
rmn	balkan romani	Balkan Romani
rmo	sinte romani	Sinte Romani
rmp	rempi	Rempi
rmq	caló	Caló
rms	romanian sign language	Romanian Sign Language
rmt	domari	Domari
rmu	tavringer romani	Tavringer Romani
rmv	romanova	Romanova
rmw	welsh romani	Welsh Romani
rmx	romam	Romam
rmy	vlax romani	Vlax Romani
rmz	marma	Marma
rnb	brunca sign language	Brunca Sign Language
rnd	ruund	Ruund
rng	ronga	Ronga
rnl	ranglong	Ranglong
rnn	roon	Roon
rnp	rongpo	Rongpo
rnr	nari nari	Nari Nari
rnw	rungwa	Rungwa
roa	romanes, langues	Romanes, Langues
rob	tae'	Tae'
roc	cacgia roglai	Cacgia Roglai
rod	rogo	Rogo
roe	ronji	Ronji
rof	rombo	Rombo
rog	northern roglai	Northern Roglai
roh	romanche	Romanche
rol	romblomanon	Romblomanon
rom	tsigane	Tsigane
ron	roumain	Roumain
roo	rotokas	Rotokas
rop	kriol	Kriol
ror	rongga	Rongga
rou	runga	Runga
row	dela-oenale	Dela-Oenale
rpn	repanbitip	Repanbitip
rpt	rapting	Rapting
rri	ririo	Ririo
rro	waima	Waima
rrt	arritinngithigh	Arritinngithigh
rsb	romano-serbian	Romano-Serbian
rsk	ruthenian	Ruthenian
rsl	russian sign language	Russian Sign Language
rsm	miriwoong sign language	Miriwoong Sign Language
rsn	rwandan sign language	Rwandan Sign Language
rtc	rungtu chin	Rungtu Chin
rth	ratahan	Ratahan
rtm	rotuman	Rotuman
rts	yurats	Yurats
rtw	rathawi	Rathawi
rub	gungu	Gungu
ruc	ruuli	Ruuli
rue	rusyn	Rusyn
ruf	luguru	Luguru
rug	roviana	Roviana
ruh	ruga	Ruga
rui	rufiji	Rufiji
ruk	che	Che
rum	roumain ; moldave	Roumain ; Moldave
run	rundi	Rundi
ruo	istro romanian	Istro Romanian
rup	aroumain ; macédo-roumain	Aroumain ; Macédo-Roumain
ruq	megleno romanian	Megleno Romanian
rus	russe	Russe
rut	rutul	Rutul
ruu	lanas lobu	Lanas Lobu
ruy	mala (nigeria)	Mala (Nigeria)
ruz	ruma	Ruma
rwa	rawo	Rawo
rwk	rwa	Rwa
rwl	ruwila	Ruwila
rwm	amba (uganda)	Amba (Uganda)
rwo	rawa	Rawa
rwr	marwari (india)	Marwari (India)
rxd	ngardi	Ngardi
rxw	karuwali	Karuwali
ryn	northern amami-oshima	Northern Amami-Oshima
rys	yaeyama	Yaeyama
ryu	central okinawan	Central Okinawan
rzh	razihi	Razihi
saa	saba	Saba
sab	buglere	Buglere
sac	meskwaki	Meskwaki
sad	sandawe	Sandawe
sae	sabanę	Sabanę
saf	safaliba	Safaliba
sag	sango	Sango
sah	iakoute	Iakoute
sai	sud-amérindiennes, langues	Sud-Amérindiennes, Langues
saj	sahu	Sahu
sak	sake	Sake
sal	salishennes, langues	Salishennes, Langues
sam	samaritain	Samaritain
san	sanskrit	Sanskrit
sao	sause	Sause
saq	samburu	Samburu
sar	saraveca	Saraveca
sas	sasak	Sasak
sat	santal	Santal
sau	saleman	Saleman
sav	saafi-saafi	Saafi-Saafi
saw	sawi	Sawi
sax	sa	Sa
say	saya	Saya
saz	saurashtra	Saurashtra
sba	ngambay	Ngambay
sbb	simbo	Simbo
sbc	kele (papua new guinea)	Kele (Papua New Guinea)
sbd	southern samo	Southern Samo
sbe	saliba	Saliba
sbf	chabu	Chabu
sbg	seget	Seget
sbh	sori-harengan	Sori-Harengan
sbi	seti	Seti
sbj	surbakhal	Surbakhal
sbk	safwa	Safwa
sbl	botolan sambal	Botolan Sambal
sbm	sagala	Sagala
sbn	sindhi bhil	Sindhi Bhil
sbo	sabüm	Sabüm
sbp	sangu (tanzania)	Sangu (Tanzania)
sbq	sileibi	Sileibi
sbr	sembakung murut	Sembakung Murut
sbs	subiya	Subiya
sbt	kimki	Kimki
sbu	stod bhoti	Stod Bhoti
sbv	sabine	Sabine
sbw	simba	Simba
sbx	seberuang	Seberuang
sby	soli	Soli
sbz	sara kaba	Sara Kaba
scb	chut	Chut
sce	dongxiang	Dongxiang
scf	san miguel creole french	San Miguel Creole French
scg	sanggau	Sanggau
sch	sakachep	Sakachep
sci	sri lankan creole malay	Sri Lankan Creole Malay
sck	sadri	Sadri
scl	shina	Shina
scn	sicilien	Sicilien
sco	écossais	Écossais
scp	hyolmo	Hyolmo
scq	sa'och	Sa'Och
scs	north slavey	North Slavey
sct	southern katang	Southern Katang
scu	shumcho	Shumcho
scv	sheni	Sheni
scw	sha	Sha
scx	sicel	Sicel
sda	toraja-sa'dan	Toraja-Sa'Dan
sdb	shabak	Shabak
sdc	sassarese sardinian	Sassarese Sardinian
sde	surubu	Surubu
sdf	sarli	Sarli
sdg	savi	Savi
sdh	southern kurdish	Southern Kurdish
sdj	suundi	Suundi
sdk	sos kundi	Sos Kundi
sdl	saudi arabian sign language	Saudi Arabian Sign Language
sdn	gallurese sardinian	Gallurese Sardinian
sdo	bukar-sadung bidayuh	Bukar-Sadung Bidayuh
sdp	sherdukpen	Sherdukpen
sdq	semandang	Semandang
sdr	oraon sadri	Oraon Sadri
sds	sened	Sened
sdt	shuadit	Shuadit
sdu	sarudu	Sarudu
sdx	sibu melanau	Sibu Melanau
sdz	sallands	Sallands
sea	semai	Semai
seb	shempire senoufo	Shempire Senoufo
sec	sechelt	Sechelt
sed	sedang	Sedang
see	seneca	Seneca
sef	cebaara senoufo	Cebaara Senoufo
seg	segeju	Segeju
seh	sena	Sena
sei	seri	Seri
sej	sene	Sene
sek	sekani	Sekani
sel	selkoupe	Selkoupe
sem	sémitiques, langues	Sémitiques, Langues
sen	nanerigé sénoufo	Nanerigé Sénoufo
seo	suarmin	Suarmin
sep	sěcěté sénoufo	Sěcěté Sénoufo
seq	senara sénoufo	Senara Sénoufo
ser	serrano	Serrano
ses	koyraboro senni songhai	Koyraboro Senni Songhai
set	sentani	Sentani
seu	serui-laut	Serui-Laut
sev	nyarafolo senoufo	Nyarafolo Senoufo
sew	sewa bay	Sewa Bay
sey	secoya	Secoya
sez	senthang chin	Senthang Chin
sfb	langue des signes de belgique francophone	Langue Des Signes De Belgique Francophone
sfe	eastern subanen	Eastern Subanen
sfm	small flowery miao	Small Flowery Miao
sfs	south african sign language	South African Sign Language
sfw	sehwi	Sehwi
sga	irlandais ancien (jusqu'à 900)	Irlandais Ancien (Jusqu'À 900)
sgb	mag-antsi ayta	Mag-Antsi Ayta
sgc	kipsigis	Kipsigis
sgd	surigaonon	Surigaonon
sge	segai	Segai
sgg	swiss-german sign language	Swiss-German Sign Language
sgh	shughni	Shughni
sgi	suga	Suga
sgj	surgujia	Surgujia
sgk	sangkong	Sangkong
sgm	singa	Singa
sgn	langues des signes	Langues Des Signes
sgp	singpho	Singpho
sgr	sangisari	Sangisari
sgs	samogitian	Samogitian
sgt	brokpake	Brokpake
sgu	salas	Salas
sgw	sebat bet gurage	Sebat Bet Gurage
sgx	sierra leone sign language	Sierra Leone Sign Language
sgy	sanglechi	Sanglechi
sgz	sursurunga	Sursurunga
sha	shall-zwall	Shall-Zwall
shb	ninam	Ninam
shc	sonde	Sonde
shd	kundal shahi	Kundal Shahi
she	sheko	Sheko
shg	shua	Shua
shh	shoshoni	Shoshoni
shi	tachelhit	Tachelhit
shj	shatt	Shatt
shk	shilluk	Shilluk
shl	shendu	Shendu
shm	shahrudi	Shahrudi
shn	chan	Chan
sho	shanga	Shanga
shp	shipibo-conibo	Shipibo-Conibo
shq	sala	Sala
shr	shi	Shi
shs	shuswap	Shuswap
sht	shasta	Shasta
shu	chadian arabic	Chadian Arabic
shv	shehri	Shehri
shw	shwai	Shwai
shx	she	She
shy	tachawit	Tachawit
shz	syenara senoufo	Syenara Senoufo
sia	akkala sami	Akkala Sami
sib	sebop	Sebop
sid	sidamo	Sidamo
sie	simaa	Simaa
sif	siamou	Siamou
sig	paasaal	Paasaal
sih	sîshëë, zire, sîchë, nerë	Sîshëë, Zire, Sîchë, Nerë
sii	shom peng	Shom Peng
sij	numbami	Numbami
sik	sikiana	Sikiana
sil	tumulung sisaala	Tumulung Sisaala
sim	mende (papua new guinea)	Mende (Papua New Guinea)
sin	singhalais	Singhalais
sio	sioux, langues	Sioux, Langues
sip	sikkimese	Sikkimese
siq	sonia	Sonia
sir	siri	Siri
sis	siuslaw	Siuslaw
sit	sino-tibétaines, langues	Sino-Tibétaines, Langues
siu	sinagen	Sinagen
siv	sumariup	Sumariup
siw	siwai	Siwai
six	sumau	Sumau
siy	sivandi	Sivandi
siz	siwi	Siwi
sja	epena	Epena
sjb	sajau basap	Sajau Basap
sjd	kildin sami	Kildin Sami
sje	pite sami	Pite Sami
sjg	assangori	Assangori
sjk	kemi sami	Kemi Sami
sjl	sajalong	Sajalong
sjm	mapun	Mapun
sjn	sindarin	Sindarin
sjo	xibe	Xibe
sjp	surjapuri	Surjapuri
sjr	siar-lak	Siar-Lak
sjs	senhaja de srair	Senhaja De Srair
sjt	ter sami	Ter Sami
sju	ume sami	Ume Sami
sjw	shawnee	Shawnee
ska	skagit	Skagit
skb	saek	Saek
skc	ma manda	Ma Manda
skd	southern sierra miwok	Southern Sierra Miwok
ske	seke (vanuatu)	Seke (Vanuatu)
skf	sakirabiá	Sakirabiá
skg	sakalava malagasy	Sakalava Malagasy
skh	sikule	Sikule
ski	sika	Sika
skj	seke (nepal)	Seke (Nepal)
skm	kutong	Kutong
skn	kolibugan subanon	Kolibugan Subanon
sko	seko tengah	Seko Tengah
skp	sekapan	Sekapan
skq	sininkere	Sininkere
skr	saraiki	Saraiki
sks	maia	Maia
skt	sakata	Sakata
sku	sakao	Sakao
skv	skou	Skou
skw	skepi creole dutch	Skepi Creole Dutch
skx	seko padang	Seko Padang
sky	sikaiana	Sikaiana
skz	sekar	Sekar
sla	slaves, langues	Slaves, Langues
slc	sáliba	Sáliba
sld	sissala	Sissala
sle	sholaga	Sholaga
slf	swiss-italian sign language	Swiss-Italian Sign Language
slg	selungai murut	Selungai Murut
slh	southern puget sound salish	Southern Puget Sound Salish
sli	lower silesian	Lower Silesian
slj	salumá	Salumá
slk	slovaque	Slovaque
sll	salt-yui	Salt-Yui
slm	pangutaran sama	Pangutaran Sama
sln	salinan	Salinan
slp	lamaholot	Lamaholot
slq	salchuq	Salchuq
slr	salar	Salar
sls	singapore sign language	Singapore Sign Language
slt	sila	Sila
slu	selaru	Selaru
slv	slovène	Slovène
slw	sialum	Sialum
slx	salampasu	Salampasu
sly	selayar	Selayar
slz	ma'ya	Ma'Ya
sma	sami du Sud	Sami Du Sud
smb	simbari	Simbari
smc	som	Som
sme	sami du Nord)	Sami Du Nord)
smf	auwe	Auwe
smg	simbali	Simbali
smh	samei	Samei
smi	sames, langues	Sames, Langues
smj	sami de Lule	Sami De Lule
smk	bolinao	Bolinao
sml	central sama	Central Sama
smm	musasa	Musasa
smn	sami d'Inari	Sami D'Inari
smo	samoan	Samoan
smp	samaritan	Samaritan
smq	samo	Samo
smr	simeulue	Simeulue
sms	sami skolt	Sami Skolt
smt	simte	Simte
smu	somray	Somray
smv	samvedi	Samvedi
smw	sumbawa	Sumbawa
smx	samba	Samba
smy	semnani	Semnani
smz	simeku	Simeku
sna	shona	Shona
snc	sinaugoro	Sinaugoro
snd	sindhi	Sindhi
sne	bau bidayuh	Bau Bidayuh
snf	noon	Noon
sng	sanga (democratic republic of congo)	Sanga (Democratic Republic Of Congo)
sni	sensi	Sensi
snj	riverain sango	Riverain Sango
snk	soninké	Soninké
snl	sangil	Sangil
snm	southern ma'di	Southern Ma'Di
snn	siona	Siona
sno	snohomish	Snohomish
snp	siane	Siane
snq	sangu (gabon)	Sangu (Gabon)
snr	sihan	Sihan
sns	south west bay	South West Bay
snu	senggi	Senggi
snv	sa'ban	Sa'Ban
snw	selee	Selee
snx	sam	Sam
sny	saniyo-hiyewe	Saniyo-Hiyewe
snz	kou	Kou
soa	thai song	Thai Song
sob	sobei	Sobei
soc	so (democratic republic of congo)	So (Democratic Republic Of Congo)
sod	songoora	Songoora
soe	songomeno	Songomeno
sog	sogdien	Sogdien
soh	aka	Aka
soi	sonha	Sonha
soj	soi	Soi
sok	sokoro	Sokoro
sol	solos	Solos
som	somali	Somali
son	songhaï, langues	Songhaï, Langues
soo	songo	Songo
sop	songe	Songe
soq	kanasi	Kanasi
sor	somrai	Somrai
sos	seeku	Seeku
sot	sotho du Sud	Sotho Du Sud
sou	southern thai	Southern Thai
sov	sonsorol	Sonsorol
sow	sowanda	Sowanda
sox	swo	Swo
soy	miyobe	Miyobe
soz	temi	Temi
spa	espagnol ; castillan	Espagnol ; Castillan
spb	sepa (indonesia)	Sepa (Indonesia)
spc	sapé	Sapé
spd	saep	Saep
spe	sepa (papua new guinea)	Sepa (Papua New Guinea)
spg	sian	Sian
spi	saponi	Saponi
spk	sengo	Sengo
spl	selepet	Selepet
spm	akukem	Akukem
spn	sanapaná	Sanapaná
spo	spokane	Spokane
spp	supyire senoufo	Supyire Senoufo
spq	loreto-ucayali spanish	Loreto-Ucayali Spanish
spr	saparua	Saparua
sps	saposa	Saposa
spt	spiti bhoti	Spiti Bhoti
spu	sapuan	Sapuan
spv	sambalpuri	Sambalpuri
spx	south picene	South Picene
spy	sabaot	Sabaot
sqa	shama-sambuga	Shama-Sambuga
sqh	shau	Shau
sqi	albanais	Albanais
sqk	albanian sign language	Albanian Sign Language
sqm	suma	Suma
sqn	susquehannock	Susquehannock
sqo	sorkhei	Sorkhei
sqq	sou	Sou
sqr	siculo arabic	Siculo Arabic
sqs	sri lankan sign language	Sri Lankan Sign Language
sqt	soqotri	Soqotri
squ	squamish	Squamish
sqx	kufr qassem sign language (kqsl)	Kufr Qassem Sign Language (Kqsl)
sra	saruga	Saruga
srb	sora	Sora
src	logudorese sardinian	Logudorese Sardinian
srd	sarde	Sarde
sre	sara	Sara
srf	nafi	Nafi
srg	sulod	Sulod
srh	sarikoli	Sarikoli
sri	siriano	Siriano
srk	serudung murut	Serudung Murut
srl	isirawa	Isirawa
srm	saramaccan	Saramaccan
srn	sranan tongo	Sranan Tongo
sro	campidanese sardinian	Campidanese Sardinian
srp	serbe	Serbe
srq	sirionó	Sirionó
srr	sérère	Sérère
srs	sarsi	Sarsi
srt	sauri	Sauri
sru	suruí	Suruí
srv	southern sorsoganon	Southern Sorsoganon
srw	serua	Serua
srx	sirmauri	Sirmauri
sry	sera	Sera
srz	shahmirzadi	Shahmirzadi
ssa	nilo-sahariennes, langues	Nilo-Sahariennes, Langues
ssb	southern sama	Southern Sama
ssc	suba-simbiti	Suba-Simbiti
ssd	siroi	Siroi
sse	balangingi	Balangingi
ssf	thao	Thao
ssg	seimat	Seimat
ssh	shihhi arabic	Shihhi Arabic
ssi	sansi	Sansi
ssj	sausi	Sausi
ssk	sunam	Sunam
ssl	western sisaala	Western Sisaala
ssm	semnam	Semnam
ssn	waata	Waata
sso	sissano	Sissano
ssp	spanish sign language	Spanish Sign Language
ssq	so'a	So'A
ssr	swiss-french sign language	Swiss-French Sign Language
sss	sô	Sô
sst	sinasina	Sinasina
ssu	susuami	Susuami
ssv	shark bay	Shark Bay
ssw	swati	Swati
ssx	samberigi	Samberigi
ssy	saho	Saho
ssz	sengseng	Sengseng
sta	settla	Settla
stb	northern subanen	Northern Subanen
std	sentinel	Sentinel
ste	liana-seti	Liana-Seti
stf	seta	Seta
stg	trieng	Trieng
sth	shelta	Shelta
sti	bulo stieng	Bulo Stieng
stj	matya samo	Matya Samo
stk	arammba	Arammba
stl	stellingwerfs	Stellingwerfs
stm	setaman	Setaman
stn	owa	Owa
sto	stoney	Stoney
stp	southeastern tepehuan	Southeastern Tepehuan
stq	saterfriesisch	Saterfriesisch
str	straits salish	Straits Salish
sts	shumashti	Shumashti
stt	budeh stieng	Budeh Stieng
stu	samtao	Samtao
stv	silt'e	Silt'E
stw	satawalese	Satawalese
sty	siberian tatar	Siberian Tatar
sua	sulka	Sulka
sub	suku	Suku
suc	western subanon	Western Subanon
sue	suena	Suena
sug	suganga	Suganga
sui	suki	Suki
suj	shubi	Shubi
suk	sukuma	Sukuma
sun	soundanais	Soundanais
suo	bouni	Bouni
suq	tirmaga-chai suri	Tirmaga-Chai Suri
sur	mwaghavul	Mwaghavul
sus	soussou	Soussou
sut	subtiaba	Subtiaba
suv	puroik	Puroik
suw	sumbwa	Sumbwa
sux	sumérien	Sumérien
suy	suyá	Suyá
suz	sunwar	Sunwar
sva	svan	Svan
svb	ulau-suain	Ulau-Suain
svc	vincentian creole english	Vincentian Creole English
sve	serili	Serili
svk	slovakian sign language	Slovakian Sign Language
svm	slavomolisano	Slavomolisano
svs	savosavo	Savosavo
svx	skalvian	Skalvian
swa	swahili	Swahili
swb	maoré / shimaoré	Maoré / Shimaoré
swc	congo swahili	Congo Swahili
swe	suédois	Suédois
swf	sere	Sere
swg	swabian	Swabian
swh	swahili (individual language)	Swahili (Individual Language)
swi	sui	Sui
swj	sira	Sira
swk	malawi sena	Malawi Sena
swl	swedish sign language	Swedish Sign Language
swm	samosa	Samosa
swn	sawknah	Sawknah
swo	shanenawa	Shanenawa
swp	suau	Suau
swq	sharwa	Sharwa
swr	saweru	Saweru
sws	seluwasan	Seluwasan
swt	sawila	Sawila
swu	suwawa	Suwawa
swv	shekhawati	Shekhawati
sww	sowa	Sowa
swx	suruahá	Suruahá
swy	sarua	Sarua
sxb	suba	Suba
sxc	sicanian	Sicanian
sxe	sighu	Sighu
sxg	shuhi	Shuhi
sxk	southern kalapuya	Southern Kalapuya
sxl	selian	Selian
sxm	samre	Samre
sxn	sangir	Sangir
sxo	sorothaptic	Sorothaptic
sxr	saaroa	Saaroa
sxs	sasaru	Sasaru
sxu	upper saxon	Upper Saxon
sxw	saxwe gbe	Saxwe Gbe
sya	siang	Siang
syb	central subanen	Central Subanen
syc	syriaque classique	Syriaque Classique
syi	seki	Seki
syk	sukur	Sukur
syl	sylheti	Sylheti
sym	maya samo	Maya Samo
syn	senaya	Senaya
syo	suoy	Suoy
syr	syriaque	Syriaque
sys	sinyar	Sinyar
syw	kagate	Kagate
syx	samay	Samay
syy	al-sayyid bedouin sign language	Al-Sayyid Bedouin Sign Language
sza	semelai	Semelai
szb	ngalum	Ngalum
szc	semaq beri	Semaq Beri
szd	seru	Seru
sze	seze	Seze
szg	sengele	Sengele
szl	silesian	Silesian
szn	sula	Sula
szp	suabo	Suabo
szs	solomon islands sign language	Solomon Islands Sign Language
szv	isu (fako division)	Isu (Fako Division)
szw	sawai	Sawai
szy	sakizaya	Sakizaya
taa	lower tanana	Lower Tanana
tab	tabassaran	Tabassaran
tac	lowland tarahumara	Lowland Tarahumara
tad	tause	Tause
tae	tariana	Tariana
taf	tapirapé	Tapirapé
tag	tagoi	Tagoi
tah	tahitien	Tahitien
tai	tai, langues	Tai, Langues
taj	eastern tamang	Eastern Tamang
tak	tala	Tala
tal	tal	Tal
tam	tamoul	Tamoul
tan	tangale	Tangale
tao	yami	Yami
tap	taabwa	Taabwa
taq	tamasheq	Tamasheq
tar	central tarahumara	Central Tarahumara
tas	tay boi	Tay Boi
tat	tatar	Tatar
tau	upper tanana	Upper Tanana
tav	tatuyo	Tatuyo
taw	tai	Tai
tax	tamki	Tamki
tay	atayal	Atayal
taz	tocho	Tocho
tba	aikană	Aikană
tbc	takia	Takia
tbd	kaki ae	Kaki Ae
tbe	tanimbili	Tanimbili
tbf	mandara	Mandara
tbg	north tairora	North Tairora
tbh	dharawal	Dharawal
tbi	gaam	Gaam
tbj	tiang	Tiang
tbk	calamian tagbanwa	Calamian Tagbanwa
tbl	tboli	Tboli
tbm	tagbu	Tagbu
tbn	barro negro tunebo	Barro Negro Tunebo
tbo	tawala	Tawala
tbp	taworta	Taworta
tbr	tumtum	Tumtum
tbs	tanguat	Tanguat
tbt	tembo (kitembo)	Tembo (Kitembo)
tbu	tubar	Tubar
tbv	tobo	Tobo
tbw	tagbanwa	Tagbanwa
tbx	kapin	Kapin
tby	tabaru	Tabaru
tbz	ditammari	Ditammari
tca	ticuna	Ticuna
tcb	tanacross	Tanacross
tcc	datooga	Datooga
tcd	tafi	Tafi
tce	southern tutchone	Southern Tutchone
tcf	malinaltepec me'phaa	Malinaltepec Me'Phaa
tcg	tamagario	Tamagario
tch	turks and caicos creole english	Turks And Caicos Creole English
tci	wára	Wára
tck	tchitchege	Tchitchege
tcl	taman (myanmar)	Taman (Myanmar)
tcm	tanahmerah	Tanahmerah
tcn	tichurong	Tichurong
tco	taungyo	Taungyo
tcp	tawr chin	Tawr Chin
tcq	kaiy	Kaiy
tcs	torres strait creole	Torres Strait Creole
tct	t'en	T'En
tcu	southeastern tarahumara	Southeastern Tarahumara
tcw	tecpatlán totonac	Tecpatlán Totonac
tcx	toda	Toda
tcy	tulu	Tulu
tcz	thado chin	Thado Chin
tda	tagdal	Tagdal
tdb	panchpargania	Panchpargania
tdc	emberá-tadó	Emberá-Tadó
tdd	tai nüa	Tai Nüa
tde	tiranige diga dogon	Tiranige Diga Dogon
tdf	talieng	Talieng
tdg	western tamang	Western Tamang
tdh	thulung	Thulung
tdi	tomadino	Tomadino
tdj	tajio	Tajio
tdk	tambas	Tambas
tdl	sur	Sur
tdm	taruma	Taruma
tdn	tondano	Tondano
tdo	teme	Teme
tdq	tita	Tita
tdr	todrah	Todrah
tds	doutai	Doutai
tdt	tetun dili	Tetun Dili
tdv	toro	Toro
tdx	tandroy-mahafaly malagasy	Tandroy-Mahafaly Malagasy
tdy	tadyawan	Tadyawan
tea	temiar	Temiar
teb	tetete	Tetete
tec	terik	Terik
ted	tepo krumen	Tepo Krumen
tee	huehuetla tepehua	Huehuetla Tepehua
tef	teressa	Teressa
teg	teke-tege	Teke-Tege
teh	tehuelche	Tehuelche
tei	torricelli	Torricelli
tek	ibali teke	Ibali Teke
tel	télougou	Télougou
tem	temne	Temne
ten	tama (colombia)	Tama (Colombia)
teo	teso	Teso
tep	tepecano	Tepecano
teq	temein	Temein
ter	tereno	Tereno
tes	tengger	Tengger
tet	tetum	Tetum
teu	soo	Soo
tev	teor	Teor
tew	tewa (usa)	Tewa (Usa)
tex	tennet	Tennet
tey	tulishi	Tulishi
tez	tetserret	Tetserret
tfi	tofin gbe	Tofin Gbe
tfn	tanaina	Tanaina
tfo	tefaro	Tefaro
tfr	teribe	Teribe
tft	ternate	Ternate
tga	sagalla	Sagalla
tgb	tobilung	Tobilung
tgc	tigak	Tigak
tgd	ciwogai	Ciwogai
tge	eastern gorkha tamang	Eastern Gorkha Tamang
tgf	chalikha	Chalikha
tgh	tobagonian creole english	Tobagonian Creole English
tgi	lawunuia	Lawunuia
tgj	tagin	Tagin
tgk	tadjik	Tadjik
tgl	tagalog	Tagalog
tgn	tandaganon	Tandaganon
tgo	sudest	Sudest
tgp	tangoa	Tangoa
tgq	tring	Tring
tgr	tareng	Tareng
tgs	nume	Nume
tgt	central tagbanwa	Central Tagbanwa
tgu	tanggu	Tanggu
tgv	tingui-boto	Tingui-Boto
tgw	tagwana senoufo	Tagwana Senoufo
tgx	tagish	Tagish
tgy	togoyo	Togoyo
tgz	tagalaka	Tagalaka
tha	thaï	Thaï
thd	kuuk thaayorre	Kuuk Thaayorre
the	chitwania tharu	Chitwania Tharu
thf	thangmi	Thangmi
thh	northern tarahumara	Northern Tarahumara
thi	tai long	Tai Long
thk	tharaka	Tharaka
thl	dangaura tharu	Dangaura Tharu
thm	aheu	Aheu
thn	thachanadan	Thachanadan
thp	thompson	Thompson
thq	kochila tharu	Kochila Tharu
thr	rana tharu	Rana Tharu
ths	thakali	Thakali
tht	tahltan	Tahltan
thu	thuri	Thuri
thv	tahaggart tamahaq	Tahaggart Tamahaq
thy	tha	Tha
thz	tayart tamajeq	Tayart Tamajeq
tia	tidikelt tamazight	Tidikelt Tamazight
tic	tira	Tira
tif	tifal	Tifal
tig	tigré	Tigré
tih	timugon murut	Timugon Murut
tii	tiene	Tiene
tij	tilung	Tilung
tik	tikar	Tikar
til	tillamook	Tillamook
tim	timbe	Timbe
tin	tindi	Tindi
tio	teop	Teop
tip	trimuris	Trimuris
tiq	tiéfo	Tiéfo
tir	tigrigna	Tigrigna
tis	masadiit itneg	Masadiit Itneg
tit	tinigua	Tinigua
tiu	adasen	Adasen
tiv	tiv	Tiv
tiw	tiwi	Tiwi
tix	southern tiwa	Southern Tiwa
tiy	tiruray	Tiruray
tiz	tai hongjin	Tai Hongjin
tja	tajuasohn	Tajuasohn
tjg	tunjung	Tunjung
tji	northern tujia	Northern Tujia
tjj	tjungundji	Tjungundji
tjl	tai laing	Tai Laing
tjm	timucua	Timucua
tjn	tonjon	Tonjon
tjo	temacine tamazight	Temacine Tamazight
tjp	tjupany	Tjupany
tjs	southern tujia	Southern Tujia
tju	tjurruru	Tjurruru
tjw	djabwurrung	Djabwurrung
tka	truká	Truká
tkb	buksa	Buksa
tkd	tukudede	Tukudede
tke	takwane	Takwane
tkf	tukumanféd	Tukumanféd
tkg	tesaka malagasy	Tesaka Malagasy
tkl	tokelau	Tokelau
tkm	takelma	Takelma
tkn	toku-no-shima	Toku-No-Shima
tkp	tikopia	Tikopia
tkq	tee	Tee
tkr	tsakhur	Tsakhur
tks	takestani	Takestani
tkt	kathoriya tharu	Kathoriya Tharu
tku	upper necaxa totonac	Upper Necaxa Totonac
tkv	mur pano	Mur Pano
tkw	teanu	Teanu
tkx	tangko	Tangko
tkz	takua	Takua
tla	southwestern tepehuan	Southwestern Tepehuan
tlb	tobelo	Tobelo
tlc	yecuatla totonac	Yecuatla Totonac
tld	talaud	Talaud
tlf	telefol	Telefol
tlg	tofanma	Tofanma
tlh	klingon	Klingon
tli	tlingit	Tlingit
tlj	talinga-bwisi	Talinga-Bwisi
tlk	taloki	Taloki
tll	tetela	Tetela
tlm	tolomako	Tolomako
tln	talondo'	Talondo'
tlo	talodi	Talodi
tlp	filomena mata-coahuitlán totonac	Filomena Mata-Coahuitlán Totonac
tlq	tai loi	Tai Loi
tlr	talise	Talise
tls	tambotalo	Tambotalo
tlt	sou nama	Sou Nama
tlu	tulehu	Tulehu
tlv	taliabu	Taliabu
tlx	khehek	Khehek
tly	talysh	Talysh
tma	tama (chad)	Tama (Chad)
tmb	katbol	Katbol
tmc	tumak	Tumak
tmd	haruai	Haruai
tme	tremembé	Tremembé
tmf	toba-maskoy	Toba-Maskoy
tmg	ternateńo	Ternateńo
tmh	tamacheq	Tamacheq
tmi	tutuba	Tutuba
tmj	samarokena	Samarokena
tmk	northwestern tamang	Northwestern Tamang
tml	tamnim citak	Tamnim Citak
tmm	tai thanh	Tai Thanh
tmn	taman (indonesia)	Taman (Indonesia)
tmo	temoq	Temoq
tmq	tumleo	Tumleo
tmr	jewish babylonian aramaic (ca. 200-1200 ce)	Jewish Babylonian Aramaic (Ca. 200-1200 Ce)
tms	tima	Tima
tmt	tasmate	Tasmate
tmu	iau	Iau
tmv	tembo (motembo)	Tembo (Motembo)
tmw	temuan	Temuan
tmy	tami	Tami
tmz	tamanaku	Tamanaku
tna	tacana	Tacana
tnb	western tunebo	Western Tunebo
tnc	tanimuca-retuară	Tanimuca-Retuară
tnd	angosturas tunebo	Angosturas Tunebo
tng	tobanga	Tobanga
tnh	maiani	Maiani
tni	tandia	Tandia
tnk	kwamera	Kwamera
tnl	lenakel	Lenakel
tnm	tabla	Tabla
tnn	north tanna	North Tanna
tno	toromono	Toromono
tnp	whitesands	Whitesands
tnq	taino	Taino
tnr	ménik	Ménik
tns	tenis	Tenis
tnt	tontemboan	Tontemboan
tnu	tay khang	Tay Khang
tnv	tangchangya	Tangchangya
tnw	tonsawang	Tonsawang
tnx	tanema	Tanema
tny	tongwe	Tongwe
tnz	ten'edn	Ten'Edn
tob	toba	Toba
toc	coyutla totonac	Coyutla Totonac
tod	toma	Toma
tof	gizrra	Gizrra
tog	tonga (Nyasa)	Tonga (Nyasa)
toh	gitonga	Gitonga
toi	tonga (zambia)	Tonga (Zambia)
toj	tojolabal	Tojolabal
tok	toki pona	Toki Pona
tol	tolowa	Tolowa
tom	tombulu	Tombulu
ton	tongan (Îles Tonga)	Tongan (Îles Tonga)
too	xicotepec de juárez totonac	Xicotepec De Juárez Totonac
top	papantla totonac	Papantla Totonac
toq	toposa	Toposa
tor	togbo-vara banda	Togbo-Vara Banda
tos	highland totonac	Highland Totonac
tou	tho	Tho
tov	upper taromi	Upper Taromi
tow	jemez	Jemez
tox	tobian	Tobian
toy	topoiyo	Topoiyo
toz	to	To
tpa	taupota	Taupota
tpc	azoyú me'phaa	Azoyú Me'Phaa
tpe	tippera	Tippera
tpf	tarpia	Tarpia
tpg	kula	Kula
tpi	tok pisin	Tok Pisin
tpj	tapieté	Tapieté
tpk	tupinikin	Tupinikin
tpl	tlacoapa me'phaa	Tlacoapa Me'Phaa
tpm	tampulma	Tampulma
tpn	tupinambá	Tupinambá
tpo	tai pao	Tai Pao
tpp	pisaflores tepehua	Pisaflores Tepehua
tpq	tukpa	Tukpa
tpr	tuparí	Tuparí
tpt	tlachichilco tepehua	Tlachichilco Tepehua
tpu	tampuan	Tampuan
tpv	tanapag	Tanapag
tpw	tupí	Tupí
tpx	acatepec me'phaa	Acatepec Me'Phaa
tpy	trumai	Trumai
tpz	tinputz	Tinputz
tqb	tembé	Tembé
tql	lehali	Lehali
tqm	turumsa	Turumsa
tqn	tenino	Tenino
tqo	toaripi	Toaripi
tqp	tomoip	Tomoip
tqq	tunni	Tunni
tqr	torona	Torona
tqt	western totonac	Western Totonac
tqu	touo	Touo
tqw	tonkawa	Tonkawa
tra	tirahi	Tirahi
trb	terebu	Terebu
trc	copala triqui	Copala Triqui
trd	turi	Turi
tre	east tarangan	East Tarangan
trf	trinidadian creole english	Trinidadian Creole English
trg	lishán didán	Lishán Didán
trh	turaka	Turaka
tri	trió	Trió
trj	toram	Toram
trl	traveller scottish	Traveller Scottish
trm	tregami	Tregami
trn	trinitario	Trinitario
tro	tarao naga	Tarao Naga
trp	kok borok	Kok Borok
trq	san martín itunyoso triqui	San Martín Itunyoso Triqui
trr	taushiro	Taushiro
trs	chicahuaxtla triqui	Chicahuaxtla Triqui
trt	tunggare	Tunggare
tru	turoyo	Turoyo
trv	sediq	Sediq
trw	torwali	Torwali
trx	tringgus-sembaan bidayuh	Tringgus-Sembaan Bidayuh
try	turung	Turung
trz	torá	Torá
tsa	tsaangi	Tsaangi
tsb	tsamai	Tsamai
tsc	tswa	Tswa
tsd	tsakonian	Tsakonian
tse	tunisian sign language	Tunisian Sign Language
tsg	tausug	Tausug
tsh	tsuvan	Tsuvan
tsi	tsimshian	Tsimshian
tsj	tshangla	Tshangla
tsk	tseku	Tseku
tsl	ts'ün-lao	Ts'Ün-Lao
tsm	turkish sign language	Turkish Sign Language
tsn	tswana	Tswana
tso	tsonga	Tsonga
tsp	northern toussian	Northern Toussian
tsq	thai sign language	Thai Sign Language
tsr	akei	Akei
tss	taiwan sign language	Taiwan Sign Language
tst	tondi songway kiini	Tondi Songway Kiini
tsu	tsou	Tsou
tsv	tsogo	Tsogo
tsw	tsishingini	Tsishingini
tsx	mubami	Mubami
tsy	tebul sign language	Tebul Sign Language
tsz	purepecha	Purepecha
tta	tutelo	Tutelo
ttb	gaa	Gaa
ttc	teko	Teko
ttd	tauade	Tauade
tte	bwanabwana	Bwanabwana
ttf	tuotomb	Tuotomb
ttg	tutong	Tutong
tth	upper ta'oih	Upper Ta'Oih
tti	tobati	Tobati
ttj	tooro	Tooro
ttk	totoro	Totoro
ttl	totela	Totela
ttm	northern tutchone	Northern Tutchone
ttn	towei	Towei
tto	lower ta'oih	Lower Ta'Oih
ttp	tombelala	Tombelala
ttq	tawallammat tamajaq	Tawallammat Tamajaq
ttr	tera	Tera
tts	northeastern thai	Northeastern Thai
ttt	muslim tat	Muslim Tat
ttu	torau	Torau
ttv	titan	Titan
ttw	long wat	Long Wat
tty	sikaritai	Sikaritai
ttz	tsum	Tsum
tua	wiarumus	Wiarumus
tub	tübatulabal	Tübatulabal
tuc	mutu	Mutu
tud	tuxá	Tuxá
tue	tuyuca	Tuyuca
tuf	central tunebo	Central Tunebo
tug	tunia	Tunia
tuh	taulil	Taulil
tui	tupuri	Tupuri
tuj	tugutil	Tugutil
tuk	turkmène	Turkmène
tul	tula	Tula
tum	tumbuka	Tumbuka
tun	tunica	Tunica
tuo	tucano	Tucano
tup	tupi, langues	Tupi, Langues
tuq	tedaga	Tedaga
tur	turc	Turc
tus	tuscarora	Tuscarora
tut	altaïques, langues	Altaïques, Langues
tuu	tututni	Tututni
tuv	turkana	Turkana
tux	tuxináwa	Tuxináwa
tuy	tugen	Tugen
tuz	turka	Turka
tva	vaghua	Vaghua
tvd	tsuvadi	Tsuvadi
tve	te'un	Te'Un
tvk	southeast ambrym	Southeast Ambrym
tvl	tuvalu	Tuvalu
tvm	tela-masbuar	Tela-Masbuar
tvn	tavoyan	Tavoyan
tvo	tidore	Tidore
tvs	taveta	Taveta
tvt	tutsa naga	Tutsa Naga
tvu	tunen	Tunen
tvw	sedoa	Sedoa
tvx	taivoan	Taivoan
tvy	timor pidgin	Timor Pidgin
twa	twana	Twana
twb	western tawbuid	Western Tawbuid
twc	teshenawa	Teshenawa
twd	twents	Twents
twe	tewa (indonesia)	Tewa (Indonesia)
twf	northern tiwa	Northern Tiwa
twg	tereweng	Tereweng
twh	tai dón	Tai Dón
twi	twi	Twi
twl	tawara	Tawara
twm	tawang monpa	Tawang Monpa
twn	twendi	Twendi
two	tswapong	Tswapong
twp	ere	Ere
twq	tasawaq	Tasawaq
twr	southwestern tarahumara	Southwestern Tarahumara
twt	turiwára	Turiwára
twu	termanu	Termanu
tww	tuwari	Tuwari
twx	tewe	Tewe
twy	tawoyan	Tawoyan
txa	tombonuo	Tombonuo
txb	tokharian b	Tokharian B
txc	tsetsaut	Tsetsaut
txe	totoli	Totoli
txg	tangut	Tangut
txh	thracian	Thracian
txi	ikpeng	Ikpeng
txj	tarjumo	Tarjumo
txm	tomini	Tomini
txn	west tarangan	West Tarangan
txo	toto	Toto
txq	tii	Tii
txr	tartessian	Tartessian
txs	tonsea	Tonsea
txt	citak	Citak
txu	kayapó	Kayapó
txx	tatana	Tatana
txy	tanosy malagasy	Tanosy Malagasy
tya	tauya	Tauya
tye	kyanga	Kyanga
tyh	o'du	O'Du
tyi	teke-tsaayi	Teke-Tsaayi
tyj	tai do	Tai Do
tyl	thu lao	Thu Lao
tyn	kombai	Kombai
typ	thaypan	Thaypan
tyr	tai daeng	Tai Daeng
tys	tŕy sa pa	Tŕy Sa Pa
tyt	tŕy tac	Tŕy Tac
tyu	kua	Kua
tyv	touva	Touva
tyx	teke-tyee	Teke-Tyee
tyy	tiyaa	Tiyaa
tyz	tŕy	Tŕy
tza	tanzanian sign language	Tanzanian Sign Language
tzh	tzeltal	Tzeltal
tzj	tz'utujil	Tz'Utujil
tzl	talossan	Talossan
tzm	central atlas tamazight	Central Atlas Tamazight
tzn	tugun	Tugun
tzo	tzotzil	Tzotzil
tzx	tabriak	Tabriak
uam	uamué	Uamué
uan	kuan	Kuan
uar	tairuma	Tairuma
uba	ubang	Ubang
ubi	ubi	Ubi
ubl	buhi'non bikol	Buhi'Non Bikol
ubr	ubir	Ubir
ubu	umbu-ungu	Umbu-Ungu
uby	ubykh	Ubykh
uda	uda	Uda
ude	udihe	Udihe
udg	muduga	Muduga
udi	udi	Udi
udj	ujir	Ujir
udl	wuzlam	Wuzlam
udm	oudmourte	Oudmourte
udu	uduk	Uduk
ues	kioko	Kioko
ufi	ufim	Ufim
uga	ougaritique	Ougaritique
ugb	kuku-ugbanh	Kuku-Ugbanh
uge	ughele	Ughele
ugh	kubachi	Kubachi
ugn	ugandan sign language	Ugandan Sign Language
ugo	ugong	Ugong
ugy	uruguayan sign language	Uruguayan Sign Language
uha	uhami	Uhami
uhn	damal	Damal
uig	ouïgour	Ouïgour
uis	uisai	Uisai
uiv	iyive	Iyive
uji	tanjijili	Tanjijili
uka	kaburi	Kaburi
ukg	ukuriguma	Ukuriguma
ukh	ukhwejo	Ukhwejo
uki	kui (india)	Kui (India)
ukk	muak sa-aak	Muak Sa-Aak
ukl	ukrainian sign language	Ukrainian Sign Language
ukp	ukpe-bayobiri	Ukpe-Bayobiri
ukq	ukwa	Ukwa
ukr	ukrainien	Ukrainien
uks	urubú-kaapor sign language	Urubú-Kaapor Sign Language
uku	ukue	Ukue
ukv	kuku	Kuku
ukw	ukwuani-aboh-ndoni	Ukwuani-Aboh-Ndoni
uky	kuuk-yak	Kuuk-Yak
ula	fungwa	Fungwa
ulb	ulukwumi	Ulukwumi
ulc	ulch	Ulch
ule	lule	Lule
ulf	usku	Usku
uli	ulithian	Ulithian
ulk	meriam mir	Meriam Mir
ull	ullatan	Ullatan
ulm	ulumanda'	Ulumanda'
uln	unserdeutsch	Unserdeutsch
ulu	uma' lung	Uma' Lung
ulw	ulwa	Ulwa
uma	umatilla	Umatilla
umb	umbundu	Umbundu
umc	marrucinian	Marrucinian
umd	umbindhamu	Umbindhamu
umg	morrobalama	Morrobalama
umi	ukit	Ukit
umm	umon	Umon
umn	makyan naga	Makyan Naga
umo	umotína	Umotína
ump	umpila	Umpila
umr	umbugarla	Umbugarla
ums	pendau	Pendau
umu	munsee	Munsee
una	north watut	North Watut
und	langue indéterminée	Langue Indéterminée
une	uneme	Uneme
ung	ngarinyin	Ngarinyin
uni	uni	Uni
unk	enawené-nawé	Enawené-Nawé
unm	unami	Unami
unn	kurnai	Kurnai
unr	mundari	Mundari
unu	unubahe	Unubahe
unx	munda	Munda
unz	unde kaili	Unde Kaili
uon	kulon	Kulon
upi	umeda	Umeda
upv	uripiv-wala-rano-atchin	Uripiv-Wala-Rano-Atchin
ura	urarina	Urarina
urb	urubú-kaapor	Urubú-Kaapor
urc	urningangg	Urningangg
urd	ourdou	Ourdou
ure	uru	Uru
urf	uradhi	Uradhi
urg	urigina	Urigina
urh	urhobo	Urhobo
uri	urim	Urim
urk	urak lawoi'	Urak Lawoi'
url	urali	Urali
urm	urapmin	Urapmin
urn	uruangnirin	Uruangnirin
uro	ura (papua new guinea)	Ura (Papua New Guinea)
urp	uru-pa-in	Uru-Pa-In
urr	lehalurup	Lehalurup
urt	urat	Urat
uru	urumi	Urumi
urv	uruava	Uruava
urw	sop	Sop
urx	urimo	Urimo
ury	orya	Orya
urz	uru-eu-wau-wau	Uru-Eu-Wau-Wau
usa	usarufa	Usarufa
ush	ushojo	Ushojo
usi	usui	Usui
usk	usaghade	Usaghade
usp	uspanteco	Uspanteco
uss	us-saare	Us-Saare
usu	uya	Uya
uta	otank	Otank
ute	ute-southern paiute	Ute-Southern Paiute
uth	ut-hun	Ut-Hun
utp	amba (solomon islands)	Amba (Solomon Islands)
utr	etulo	Etulo
utu	utu	Utu
uum	urum	Urum
uur	ura (vanuatu)	Ura (Vanuatu)
uuu	u	U
uve	fagauvea	Fagauvea
uvh	uri	Uri
uvl	lote	Lote
uwa	kuku-uwanh	Kuku-Uwanh
uya	doko-uyanga	Doko-Uyanga
uzb	ouzbek	Ouzbek
uzn	northern uzbek	Northern Uzbek
uzs	southern uzbek	Southern Uzbek
vaa	vaagri booli	Vaagri Booli
vae	vale	Vale
vaf	vafsi	Vafsi
vag	vagla	Vagla
vah	varhadi-nagpuri	Varhadi-Nagpuri
vai	vaï	Vaï
vaj	sekele	Sekele
val	vehes	Vehes
vam	vanimo	Vanimo
van	valman	Valman
vao	vao	Vao
vap	vaiphei	Vaiphei
var	huarijio	Huarijio
vas	vasavi	Vasavi
vau	vanuma	Vanuma
vav	varli	Varli
vay	wayu	Wayu
vbb	southeast babar	Southeast Babar
vbk	southwestern bontok	Southwestern Bontok
vec	venetian	Venetian
ved	veddah	Veddah
vel	veluws	Veluws
vem	vemgo-mabas	Vemgo-Mabas
ven	venda	Venda
veo	ventureńo	Ventureńo
vep	veps	Veps
ver	mom jango	Mom Jango
vgr	vaghri	Vaghri
vgt	vlaamse gebarentaal	Vlaamse Gebarentaal
vic	virgin islands creole english	Virgin Islands Creole English
vid	vidunda	Vidunda
vie	vietnamien	Vietnamien
vif	vili	Vili
vig	viemo	Viemo
vil	vilela	Vilela
vin	vinza	Vinza
vis	vishavan	Vishavan
vit	viti	Viti
viv	iduna	Iduna
vka	kariyarra	Kariyarra
vkj	kujarge	Kujarge
vkk	kaur	Kaur
vkl	kulisusu	Kulisusu
vkm	kamakan	Kamakan
vkn	koro nulu	Koro Nulu
vko	kodeoha	Kodeoha
vkp	korlai creole portuguese	Korlai Creole Portuguese
vkt	tenggarong kutai malay	Tenggarong Kutai Malay
vku	kurrama	Kurrama
vkz	koro zuba	Koro Zuba
vlp	valpei	Valpei
vls	flamand occidental	Flamand Occidental
vma	martuyhunira	Martuyhunira
vmb	barbaram	Barbaram
vmc	juxtlahuaca mixtec	Juxtlahuaca Mixtec
vmd	mudu koraga	Mudu Koraga
vme	east masela	East Masela
vmf	mainfränkisch	Mainfränkisch
vmg	lungalunga	Lungalunga
vmh	maraghei	Maraghei
vmi	miwa	Miwa
vmj	ixtayutla mixtec	Ixtayutla Mixtec
vmk	makhuwa-shirima	Makhuwa-Shirima
vml	malgana	Malgana
vmm	mitlatongo mixtec	Mitlatongo Mixtec
vmp	soyaltepec mazatec	Soyaltepec Mazatec
vmq	soyaltepec mixtec	Soyaltepec Mixtec
vmr	marenje	Marenje
vms	moksela	Moksela
vmu	muluridyi	Muluridyi
vmv	valley maidu	Valley Maidu
vmw	makhuwa	Makhuwa
vmx	tamazola mixtec	Tamazola Mixtec
vmy	ayautla mazatec	Ayautla Mazatec
vmz	mazatlán mazatec	Mazatlán Mazatec
vnk	vano	Vano
vnm	vinmavis	Vinmavis
vnp	vunapu	Vunapu
vol	volapük	Volapük
vor	voro	Voro
vot	vote	Vote
vra	vera'a	Vera'A
vro	vőro	Vőro
vrs	varisi	Varisi
vrt	burmbar	Burmbar
vsi	moldova sign language	Moldova Sign Language
vsl	venezuelan sign language	Venezuelan Sign Language
vsv	valencian sign language	Valencian Sign Language
vto	vitou	Vitou
vum	vumbu	Vumbu
vun	vunjo	Vunjo
vut	vute	Vute
vwa	awa (china)	Awa (China)
waa	walla walla	Walla Walla
wab	wab	Wab
wac	wasco-wishram	Wasco-Wishram
wad	wamesa	Wamesa
wae	walser	Walser
waf	wakoná	Wakoná
wag	wa'ema	Wa'Ema
wah	watubela	Watubela
wai	wares	Wares
waj	waffa	Waffa
wak	wakashanes, langues	Wakashanes, Langues
wal	wolaitta ; wolaytta	Wolaitta ; Wolaytta
wam	wampanoag	Wampanoag
wan	wan	Wan
wao	wappo	Wappo
wap	wapishana	Wapishana
waq	wagiman	Wagiman
war	waray	Waray
was	washo	Washo
wat	kaninuwa	Kaninuwa
wau	waurá	Waurá
wav	waka	Waka
waw	waiwai	Waiwai
wax	watam	Watam
way	wayana	Wayana
waz	wampur	Wampur
wba	warao	Warao
wbb	wabo	Wabo
wbe	waritai	Waritai
wbf	wara	Wara
wbh	wanda	Wanda
wbi	vwanji	Vwanji
wbj	alagwa	Alagwa
wbk	waigali	Waigali
wbl	wakhi	Wakhi
wbm	wa	Wa
wbp	warlpiri	Warlpiri
wbq	waddar	Waddar
wbr	wagdi	Wagdi
wbs	west bengal sign language	West Bengal Sign Language
wbt	warnman	Warnman
wbv	wajarri	Wajarri
wbw	woi	Woi
wca	yanomámi	Yanomámi
wci	waci gbe	Waci Gbe
wdd	wandji	Wandji
wdg	wadaginam	Wadaginam
wdj	wadjiginy	Wadjiginy
wdk	wadikali	Wadikali
wdt	wendat	Wendat
wdu	wadjigu	Wadjigu
wdy	wadjabangayi	Wadjabangayi
wea	wewaw	Wewaw
wec	wč western	Wč Western
wed	wedau	Wedau
weg	wergaia	Wergaia
weh	weh	Weh
wei	kiunum	Kiunum
wem	weme gbe	Weme Gbe
wen	sorabes, langues	Sorabes, Langues
weo	wemale	Wemale
wep	westphalien	Westphalien
wer	weri	Weri
wes	cameroon pidgin	Cameroon Pidgin
wet	perai	Perai
weu	rawngtu chin	Rawngtu Chin
wew	wejewa	Wejewa
wfg	yafi	Yafi
wga	wagaya	Wagaya
wgb	wagawaga	Wagawaga
wgg	wangkangurru	Wangkangurru
wgi	wahgi	Wahgi
wgo	waigeo	Waigeo
wgu	wirangu	Wirangu
wgy	warrgamay	Warrgamay
wha	sou upaa	Sou Upaa
whg	north wahgi	North Wahgi
whk	wahau kenyah	Wahau Kenyah
whu	wahau kayan	Wahau Kayan
wib	southern toussian	Southern Toussian
wic	wichita	Wichita
wie	wik-epa	Wik-Epa
wif	wik-keyangan	Wik-Keyangan
wig	wik ngathan	Wik Ngathan
wih	wik-me'anha	Wik-Me'Anha
wii	minidien	Minidien
wij	wik-iiyanh	Wik-Iiyanh
wik	wikalkan	Wikalkan
wil	wilawila	Wilawila
wim	wik-mungkan	Wik-Mungkan
win	ho-chunk	Ho-Chunk
wir	wiraféd	Wiraféd
wiu	wiru	Wiru
wiv	vitu	Vitu
wiy	wiyot	Wiyot
wja	waja	Waja
wji	warji	Warji
wka	kw'adza	Kw'Adza
wkb	kumbaran	Kumbaran
wkd	wakde	Wakde
wkl	kalanadi	Kalanadi
wkr	keerray-woorroong	Keerray-Woorroong
wku	kunduvadi	Kunduvadi
wkw	wakawaka	Wakawaka
wky	wangkayutyuru	Wangkayutyuru
wla	walio	Walio
wlc	mwali comorian	Mwali Comorian
wle	wolane	Wolane
wlg	kunbarlang	Kunbarlang
wlh	welaun	Welaun
wli	waioli	Waioli
wlk	wailaki	Wailaki
wll	wali (sudan)	Wali (Sudan)
wlm	middle welsh	Middle Welsh
wln	wallon	Wallon
wlo	wolio	Wolio
wlr	wailapa	Wailapa
wls	wallisien	Wallisien
wlu	wuliwuli	Wuliwuli
wlv	wichí lhamtés vejoz	Wichí Lhamtés Vejoz
wlw	walak	Walak
wlx	wali (ghana)	Wali (Ghana)
wly	waling	Waling
wma	mawa (nigeria)	Mawa (Nigeria)
wmb	wambaya	Wambaya
wmc	wamas	Wamas
wmd	mamaindé	Mamaindé
wme	wambule	Wambule
wmg	western minyag	Western Minyag
wmh	waima'a	Waima'A
wmi	wamin	Wamin
wmm	maiwa (indonesia)	Maiwa (Indonesia)
wmn	waamwang	Waamwang
wmo	wom (papua new guinea)	Wom (Papua New Guinea)
wms	wambon	Wambon
wmt	walmajarri	Walmajarri
wmw	mwani	Mwani
wmx	womo	Womo
wnb	wanambre	Wanambre
wnc	wantoat	Wantoat
wnd	wandarang	Wandarang
wne	waneci	Waneci
wng	wanggom	Wanggom
wni	ndzwani comorian	Ndzwani Comorian
wnk	wanukaka	Wanukaka
wnm	wanggamala	Wanggamala
wnn	wunumara	Wunumara
wno	wano	Wano
wnp	wanap	Wanap
wnu	usan	Usan
wnw	wintu	Wintu
wny	wanyi	Wanyi
woa	kuwema	Kuwema
wob	wč northern	Wč Northern
woc	wogeo	Wogeo
wod	wolani	Wolani
woe	woleaian	Woleaian
wof	gambian wolof	Gambian Wolof
wog	wogamusin	Wogamusin
woi	kamang	Kamang
wok	longto	Longto
wol	wolof	Wolof
wom	wom (nigeria)	Wom (Nigeria)
won	wongo	Wongo
woo	manombai	Manombai
wor	woria	Woria
wos	hanga hundi	Hanga Hundi
wow	wawonii	Wawonii
woy	weyto	Weyto
wpc	maco	Maco
wrb	waluwarra	Waluwarra
wrg	warungu	Warungu
wrh	wiradjuri	Wiradjuri
wri	wariyangga	Wariyangga
wrk	garrwa	Garrwa
wrl	warlmanpa	Warlmanpa
wrm	warumungu	Warumungu
wrn	warnang	Warnang
wro	worrorra	Worrorra
wrp	waropen	Waropen
wrr	wardaman	Wardaman
wrs	waris	Waris
wru	waru	Waru
wrv	waruna	Waruna
wrw	gugu warra	Gugu Warra
wrx	wae rana	Wae Rana
wry	merwari	Merwari
wrz	waray (australia)	Waray (Australia)
wsa	warembori	Warembori
wsg	adilabad gondi	Adilabad Gondi
wsi	wusi	Wusi
wsk	waskia	Waskia
wsr	owenia	Owenia
wss	wasa	Wasa
wsu	wasu	Wasu
wsv	wotapuri-katarqalai	Wotapuri-Katarqalai
wtf	watiwa	Watiwa
wth	wathawurrung	Wathawurrung
wti	berta	Berta
wtk	watakataui	Watakataui
wtm	mewati	Mewati
wtw	wotu	Wotu
wua	wikngenchera	Wikngenchera
wub	wunambal	Wunambal
wud	wudu	Wudu
wuh	wutunhua	Wutunhua
wul	silimo	Silimo
wum	wumbvu	Wumbvu
wun	bungu	Bungu
wur	wurrugu	Wurrugu
wut	wutung	Wutung
wuu	wu chinese	Wu Chinese
wuv	wuvulu-aua	Wuvulu-Aua
wux	wulna	Wulna
wuy	wauyai	Wauyai
wwa	waama	Waama
wwb	wakabunga	Wakabunga
wwo	wetamut	Wetamut
wwr	warrwa	Warrwa
www	wawa	Wawa
wxa	waxianghua	Waxianghua
wxw	wardandi	Wardandi
wyb	wangaaybuwan-ngiyambaa	Wangaaybuwan-Ngiyambaa
wyi	woiwurrung	Woiwurrung
wym	wymysorys	Wymysorys
wyn	wyandot	Wyandot
wyr	wayoró	Wayoró
wyy	western fijian	Western Fijian
xaa	andalusian arabic	Andalusian Arabic
xab	sambe	Sambe
xac	kachari	Kachari
xad	adai	Adai
xae	aequian	Aequian
xag	aghwan	Aghwan
xai	kaimbé	Kaimbé
xaj	ararandewára	Ararandewára
xak	maku	Maku
xal	kalmouk ; oïrat	Kalmouk ; Oïrat
xam	xam	Xam
xan	xamtanga	Xamtanga
xao	khao	Khao
xap	apalachee	Apalachee
xaq	aquitanian	Aquitanian
xar	karami	Karami
xas	kamas	Kamas
xat	katawixi	Katawixi
xau	kauwera	Kauwera
xav	xavánte	Xavánte
xaw	kawaiisu	Kawaiisu
xay	kayan mahakam	Kayan Mahakam
xbb	lower burdekin	Lower Burdekin
xbc	bactrian	Bactrian
xbd	bindal	Bindal
xbe	bigambal	Bigambal
xbg	bunganditj	Bunganditj
xbi	kombio	Kombio
xbj	birrpayi	Birrpayi
xbm	middle breton	Middle Breton
xbn	kenaboi	Kenaboi
xbo	bolgarian	Bolgarian
xbp	bibbulman	Bibbulman
xbr	kambera	Kambera
xbw	kambiwá	Kambiwá
xby	batjala	Batjala
xcb	cumbric	Cumbric
xcc	camunic	Camunic
xce	celtiberian	Celtiberian
xcg	cisalpine gaulish	Cisalpine Gaulish
xch	chemakum	Chemakum
xcl	classical armenian	Classical Armenian
xcm	comecrudo	Comecrudo
xcn	cotoname	Cotoname
xco	chorasmian	Chorasmian
xcr	carian	Carian
xct	classical tibetan	Classical Tibetan
xcu	curonian	Curonian
xcv	chuvantsy	Chuvantsy
xcw	coahuilteco	Coahuilteco
xcy	cayuse	Cayuse
xda	darkinyung	Darkinyung
xdc	dacian	Dacian
xdk	dharuk	Dharuk
xdm	edomite	Edomite
xdo	kwandu	Kwandu
xdq	kaitag	Kaitag
xdy	malayic dayak	Malayic Dayak
xeb	eblan	Eblan
xed	hdi	Hdi
xeg	xegwi	Xegwi
xel	kelo	Kelo
xem	kembayan	Kembayan
xep	epi-olmec	Epi-Olmec
xer	xerénte	Xerénte
xes	kesawai	Kesawai
xet	xetá	Xetá
xeu	keoru-ahia	Keoru-Ahia
xfa	faliscan	Faliscan
xga	galatian	Galatian
xgb	gbin	Gbin
xgd	gudang	Gudang
xgf	gabrielino-fernandeńo	Gabrielino-Fernandeńo
xgg	goreng	Goreng
xgi	garingbal	Garingbal
xgl	galindan	Galindan
xgm	dharumbal	Dharumbal
xgr	garza	Garza
xgu	unggumi	Unggumi
xgw	guwa	Guwa
xha	harami	Harami
xhc	hunnic	Hunnic
xhd	hadrami	Hadrami
xhe	khetrani	Khetrani
xhm	middle khmer (1400 to 1850 ce)	Middle Khmer (1400 To 1850 Ce)
xho	xhosa	Xhosa
xhr	hernican	Hernican
xht	hattic	Hattic
xhu	hurrian	Hurrian
xhv	khua	Khua
xib	iberian	Iberian
xii	xiri	Xiri
xil	illyrian	Illyrian
xin	xinca	Xinca
xir	xiriàna	Xiriàna
xis	kisan	Kisan
xiv	indus valley language	Indus Valley Language
xiy	xipaya	Xipaya
xjb	minjungbal	Minjungbal
xjt	jaitmatang	Jaitmatang
xka	kalkoti	Kalkoti
xkb	northern nago	Northern Nago
xkc	kho'ini	Kho'Ini
xkd	mendalam kayan	Mendalam Kayan
xke	kereho	Kereho
xkf	khengkha	Khengkha
xkg	kagoro	Kagoro
xki	kenyan sign language	Kenyan Sign Language
xkj	kajali	Kajali
xkk	kachok	Kachok
xkl	mainstream kenyah	Mainstream Kenyah
xkn	kayan river kayan	Kayan River Kayan
xko	kiorr	Kiorr
xkp	kabatei	Kabatei
xkq	koroni	Koroni
xkr	xakriabá	Xakriabá
xks	kumbewaha	Kumbewaha
xkt	kantosi	Kantosi
xku	kaamba	Kaamba
xkv	kgalagadi	Kgalagadi
xkw	kembra	Kembra
xkx	karore	Karore
xky	uma' lasan	Uma' Lasan
xkz	kurtokha	Kurtokha
xla	kamula	Kamula
xlb	loup b	Loup B
xlc	lycian	Lycian
xld	lydian	Lydian
xle	lemnian	Lemnian
xlg	ligurian (ancient)	Ligurian (Ancient)
xli	liburnian	Liburnian
xln	alanic	Alanic
xlo	loup a	Loup A
xlp	lepontic	Lepontic
xls	lusitanian	Lusitanian
xlu	cuneiform luwian	Cuneiform Luwian
xly	elymian	Elymian
xma	mushungulu	Mushungulu
xmb	mbonga	Mbonga
xmc	makhuwa-marrevone	Makhuwa-Marrevone
xmd	mbudum	Mbudum
xme	median	Median
xmf	mingrelian	Mingrelian
xmg	mengaka	Mengaka
xmh	kugu-muminh	Kugu-Muminh
xmj	majera	Majera
xmk	ancient macedonian	Ancient Macedonian
xml	malaysian sign language	Malaysian Sign Language
xmm	manado malay	Manado Malay
xmn	manichaean middle persian	Manichaean Middle Persian
xmo	morerebi	Morerebi
xmp	kuku-mu'inh	Kuku-Mu'Inh
xmq	kuku-mangk	Kuku-Mangk
xmr	meroitic	Meroitic
xms	moroccan sign language	Moroccan Sign Language
xmt	matbat	Matbat
xmu	kamu	Kamu
xmv	antankarana malagasy	Antankarana Malagasy
xmw	tsimihety malagasy	Tsimihety Malagasy
xmx	salawati	Salawati
xmy	mayaguduna	Mayaguduna
xmz	mori bawah	Mori Bawah
xna	ancient north arabian	Ancient North Arabian
xnb	kanakanabu	Kanakanabu
xng	middle mongolian	Middle Mongolian
xnh	kuanhua	Kuanhua
xni	ngarigu	Ngarigu
xnj	ngoni (tanzania)	Ngoni (Tanzania)
xnk	nganakarti	Nganakarti
xnm	ngumbarl	Ngumbarl
xnn	northern kankanay	Northern Kankanay
xno	anglo-norman	Anglo-Norman
xnq	ngoni (mozambique)	Ngoni (Mozambique)
xnr	kangri	Kangri
xns	kanashi	Kanashi
xnt	narragansett	Narragansett
xnu	nukunul	Nukunul
xny	nyiyaparli	Nyiyaparli
xnz	kenzi	Kenzi
xoc	o'chi'chi'	O'Chi'Chi'
xod	kokoda	Kokoda
xog	soga	Soga
xoi	kominimung	Kominimung
xok	xokleng	Xokleng
xom	komo (sudan)	Komo (Sudan)
xon	konkomba	Konkomba
xoo	xukurú	Xukurú
xop	kopar	Kopar
xor	korubo	Korubo
xow	kowaki	Kowaki
xpa	pirriya	Pirriya
xpb	northeastern tasmanian	Northeastern Tasmanian
xpc	pecheneg	Pecheneg
xpd	oyster bay tasmanian	Oyster Bay Tasmanian
xpe	liberia kpelle	Liberia Kpelle
xpf	southeast tasmanian	Southeast Tasmanian
xpg	phrygian	Phrygian
xph	north midlands tasmanian	North Midlands Tasmanian
xpi	pictish	Pictish
xpj	mpalitjanh	Mpalitjanh
xpk	kulina pano	Kulina Pano
xpl	port sorell tasmanian	Port Sorell Tasmanian
xpm	pumpokol	Pumpokol
xpn	kapinawá	Kapinawá
xpo	pochutec	Pochutec
xpp	puyo-paekche	Puyo-Paekche
xpq	mohegan-pequot	Mohegan-Pequot
xpr	parthian	Parthian
xps	pisidian	Pisidian
xpt	punthamara	Punthamara
xpu	punic	Punic
xpv	northern tasmanian	Northern Tasmanian
xpw	northwestern tasmanian	Northwestern Tasmanian
xpx	southwestern tasmanian	Southwestern Tasmanian
xpy	puyo	Puyo
xpz	bruny island tasmanian	Bruny Island Tasmanian
xqa	karakhanid	Karakhanid
xqt	qatabanian	Qatabanian
xra	krahô	Krahô
xrb	eastern karaboro	Eastern Karaboro
xrd	gundungurra	Gundungurra
xre	kreye	Kreye
xrg	minang	Minang
xri	krikati-timbira	Krikati-Timbira
xrm	armazic	Armazic
xrn	arin	Arin
xrr	raetic	Raetic
xrt	aranama-tamique	Aranama-Tamique
xru	marriammu	Marriammu
xrw	karawa	Karawa
xsa	sabaean	Sabaean
xsb	sambal	Sambal
xsc	scythian	Scythian
xsd	sidetic	Sidetic
xse	sempan	Sempan
xsh	shamang	Shamang
xsi	sio	Sio
xsj	subi	Subi
xsl	south slavey	South Slavey
xsm	kasem	Kasem
xsn	sanga (nigeria)	Sanga (Nigeria)
xso	solano	Solano
xsp	silopi	Silopi
xsq	makhuwa-saka	Makhuwa-Saka
xsr	sherpa	Sherpa
xss	assan	Assan
xsu	sanumá	Sanumá
xsv	sudovian	Sudovian
xsy	saisiyat	Saisiyat
xta	alcozauca mixtec	Alcozauca Mixtec
xtb	chazumba mixtec	Chazumba Mixtec
xtc	katcha-kadugli-miri	Katcha-Kadugli-Miri
xtd	diuxi-tilantongo mixtec	Diuxi-Tilantongo Mixtec
xte	ketengban	Ketengban
xtg	transalpine gaulish	Transalpine Gaulish
xth	yitha yitha	Yitha Yitha
xti	sinicahua mixtec	Sinicahua Mixtec
xtj	san juan teita mixtec	San Juan Teita Mixtec
xtl	tijaltepec mixtec	Tijaltepec Mixtec
xtm	magdalena peńasco mixtec	Magdalena Peńasco Mixtec
xtn	northern tlaxiaco mixtec	Northern Tlaxiaco Mixtec
xto	tokharian a	Tokharian A
xtp	san miguel piedras mixtec	San Miguel Piedras Mixtec
xtq	tumshuqese	Tumshuqese
xtr	early tripuri	Early Tripuri
xts	sindihui mixtec	Sindihui Mixtec
xtt	tacahua mixtec	Tacahua Mixtec
xtu	cuyamecalco mixtec	Cuyamecalco Mixtec
xtv	thawa	Thawa
xtw	tawandę	Tawandę
xty	yoloxochitl mixtec	Yoloxochitl Mixtec
xua	alu kurumba	Alu Kurumba
xub	betta kurumba	Betta Kurumba
xud	umiida	Umiida
xug	kunigami	Kunigami
xuj	jennu kurumba	Jennu Kurumba
xul	ngunawal	Ngunawal
xum	umbrian	Umbrian
xun	unggaranggu	Unggaranggu
xuo	kuo	Kuo
xup	upper umpqua	Upper Umpqua
xur	urartian	Urartian
xut	kuthant	Kuthant
xuu	kxoe	Kxoe
xve	venetic	Venetic
xvi	kamviri	Kamviri
xvn	vandalic	Vandalic
xvo	volscian	Volscian
xvs	vestinian	Vestinian
xwa	kwaza	Kwaza
xwc	woccon	Woccon
xwd	wadi wadi	Wadi Wadi
xwe	xwela gbe	Xwela Gbe
xwg	kwegu	Kwegu
xwj	wajuk	Wajuk
xwk	wangkumara	Wangkumara
xwl	western xwla gbe	Western Xwla Gbe
xwo	written oirat	Written Oirat
xwr	kwerba mamberamo	Kwerba Mamberamo
xwt	wotjobaluk	Wotjobaluk
xww	wemba wemba	Wemba Wemba
xxb	boro (ghana)	Boro (Ghana)
xxk	ke'o	Ke'O
xxm	minkin	Minkin
xxr	koropó	Koropó
xxt	tambora	Tambora
xya	yaygir	Yaygir
xyb	yandjibara	Yandjibara
xyj	mayi-yapi	Mayi-Yapi
xyk	mayi-kulan	Mayi-Kulan
xyl	yalakalore	Yalakalore
xyt	mayi-thakurti	Mayi-Thakurti
xyy	yorta yorta	Yorta Yorta
xzh	zhang-zhung	Zhang-Zhung
xzm	zemgalian	Zemgalian
xzp	ancient zapotec	Ancient Zapotec
yaa	yaminahua	Yaminahua
yab	yuhup	Yuhup
yac	pass valley yali	Pass Valley Yali
yad	yagua	Yagua
yae	pumé	Pumé
yaf	yaka (democratic republic of congo)	Yaka (Democratic Republic Of Congo)
yag	yámana	Yámana
yah	yazgulyam	Yazgulyam
yai	yagnobi	Yagnobi
yaj	banda-yangere	Banda-Yangere
yak	yakama	Yakama
yal	yalunka	Yalunka
yam	yamba	Yamba
yan	mayangna	Mayangna
yao	yao	Yao
yap	yapois	Yapois
yaq	yaqui	Yaqui
yar	yabarana	Yabarana
yas	nugunu (cameroon)	Nugunu (Cameroon)
yat	yambeta	Yambeta
yau	yuwana	Yuwana
yav	yangben	Yangben
yaw	yawalapití	Yawalapití
yax	yauma	Yauma
yay	agwagwune	Agwagwune
yaz	lokaa	Lokaa
yba	yala	Yala
ybb	yemba	Yemba
ybe	west yugur	West Yugur
ybh	yakha	Yakha
ybi	yamphu	Yamphu
ybj	hasha	Hasha
ybk	bokha	Bokha
ybl	yukuben	Yukuben
ybm	yaben	Yaben
ybn	yabaàna	Yabaàna
ybo	yabong	Yabong
ybx	yawiyo	Yawiyo
yby	yaweyuha	Yaweyuha
ych	chesu	Chesu
ycl	lolopo	Lolopo
ycn	yucuna	Yucuna
ycp	chepya	Chepya
yda	yanda	Yanda
ydd	eastern yiddish	Eastern Yiddish
yde	yangum dey	Yangum Dey
ydg	yidgha	Yidgha
ydk	yoidik	Yoidik
yea	ravula	Ravula
yec	yeniche	Yeniche
yee	yimas	Yimas
yei	yeni	Yeni
yej	yevanic	Yevanic
yel	yela	Yela
yer	tarok	Tarok
yes	nyankpa	Nyankpa
yet	yetfa	Yetfa
yeu	yerukula	Yerukula
yev	yapunda	Yapunda
yey	yeyi	Yeyi
yga	malyangapa	Malyangapa
ygi	yiningayi	Yiningayi
ygl	yangum gel	Yangum Gel
ygm	yagomi	Yagomi
ygp	gepo	Gepo
ygr	yagaria	Yagaria
ygs	yol?u sign language	Yol?U Sign Language
ygu	yugul	Yugul
ygw	yagwoia	Yagwoia
yha	baha buyang	Baha Buyang
yhd	judeo-iraqi arabic	Judeo-Iraqi Arabic
yhl	hlepho phowa	Hlepho Phowa
yhs	yan-nhangu sign language	Yan-Nhangu Sign Language
yia	yinggarda	Yinggarda
yid	yiddish	Yiddish
yif	ache	Ache
yig	wusa nasu	Wusa Nasu
yih	western yiddish	Western Yiddish
yii	yidiny	Yidiny
yij	yindjibarndi	Yindjibarndi
yik	dongshanba lalo	Dongshanba Lalo
yil	yindjilandji	Yindjilandji
yim	yimchungru naga	Yimchungru Naga
yin	riang lai	Riang Lai
yip	pholo	Pholo
yiq	miqie	Miqie
yir	north awyu	North Awyu
yis	yis	Yis
yit	eastern lalu	Eastern Lalu
yiu	awu	Awu
yiv	northern nisu	Northern Nisu
yix	axi yi	Axi Yi
yiz	azhe	Azhe
yka	yakan	Yakan
ykg	northern yukaghir	Northern Yukaghir
yki	yoke	Yoke
ykk	yakaikeke	Yakaikeke
ykl	khlula	Khlula
ykm	kap	Kap
ykn	kua-nsi	Kua-Nsi
yko	yasa	Yasa
ykr	yekora	Yekora
ykt	kathu	Kathu
yku	kuamasi	Kuamasi
yky	yakoma	Yakoma
yla	yaul	Yaul
ylb	yaleba	Yaleba
yle	yele	Yele
ylg	yelogu	Yelogu
yli	angguruk yali	Angguruk Yali
yll	yil	Yil
ylm	limi	Limi
yln	langnian buyang	Langnian Buyang
ylo	naluo yi	Naluo Yi
ylr	yalarnnga	Yalarnnga
ylu	aribwaung	Aribwaung
yly	nyelàyu	Nyelàyu
ymb	yambes	Yambes
ymc	southern muji	Southern Muji
ymd	muda	Muda
yme	yameo	Yameo
ymg	yamongeri	Yamongeri
ymh	mili	Mili
ymi	moji	Moji
ymk	makwe	Makwe
yml	iamalele	Iamalele
ymm	maay	Maay
ymn	yamna	Yamna
ymo	yangum mon	Yangum Mon
ymp	yamap	Yamap
ymq	qila muji	Qila Muji
ymr	malasar	Malasar
yms	mysian	Mysian
ymx	northern muji	Northern Muji
ymz	muzi	Muzi
yna	aluo	Aluo
ynd	yandruwandha	Yandruwandha
yne	lang'e	Lang'E
yng	yango	Yango
ynk	naukan yupik	Naukan Yupik
ynl	yangulam	Yangulam
ynn	yana	Yana
yno	yong	Yong
ynq	yendang	Yendang
yns	yansi	Yansi
ynu	yahuna	Yahuna
yob	yoba	Yoba
yog	yogad	Yogad
yoi	yonaguni	Yonaguni
yok	yokuts	Yokuts
yol	yola	Yola
yom	yombe	Yombe
yon	yongkom	Yongkom
yor	yoruba	Yoruba
yot	yotti	Yotti
yox	yoron	Yoron
yoy	yoy	Yoy
ypa	phala	Phala
ypb	labo phowa	Labo Phowa
ypg	phola	Phola
yph	phupha	Phupha
ypk	yupik, langues	Yupik, Langues
ypm	phuma	Phuma
ypn	ani phowa	Ani Phowa
ypo	alo phola	Alo Phola
ypp	phupa	Phupa
ypz	phuza	Phuza
yra	yerakai	Yerakai
yrb	yareba	Yareba
yre	yaouré	Yaouré
yrk	nenets	Nenets
yrl	nhengatu	Nhengatu
yrm	yirrk-mel	Yirrk-Mel
yrn	yerong	Yerong
yro	yaroame	Yaroame
yrs	yarsun	Yarsun
yrw	yarawata	Yarawata
yry	yarluyandi	Yarluyandi
ysc	yassic	Yassic
ysd	samatao	Samatao
ysg	sonaga	Sonaga
ysl	yugoslavian sign language	Yugoslavian Sign Language
ysm	myanmar sign language	Myanmar Sign Language
ysn	sani	Sani
yso	nisi (china)	Nisi (China)
ysp	southern lolopo	Southern Lolopo
ysr	sirenik yupik	Sirenik Yupik
yss	yessan-mayo	Yessan-Mayo
ysy	sanie	Sanie
yta	talu	Talu
ytl	tanglang	Tanglang
ytp	thopho	Thopho
ytw	yout wam	Yout Wam
yty	yatay	Yatay
yua	yucateco	Yucateco
yub	yugambal	Yugambal
yuc	yuchi	Yuchi
yud	judeo-tripolitanian arabic	Judeo-Tripolitanian Arabic
yue	yue chinese	Yue Chinese
yuf	havasupai-walapai-yavapai	Havasupai-Walapai-Yavapai
yug	yug	Yug
yui	yurutí	Yurutí
yuj	karkar-yuri	Karkar-Yuri
yuk	yuki	Yuki
yul	yulu	Yulu
yum	quechan	Quechan
yun	bena (nigeria)	Bena (Nigeria)
yup	yukpa	Yukpa
yuq	yuqui	Yuqui
yur	yurok	Yurok
yut	yopno	Yopno
yuw	yau (morobe province)	Yau (Morobe Province)
yux	southern yukaghir	Southern Yukaghir
yuy	east yugur	East Yugur
yuz	yuracare	Yuracare
yva	yawa	Yawa
yvt	yavitero	Yavitero
ywa	kalou	Kalou
ywg	yinhawangka	Yinhawangka
ywl	western lalu	Western Lalu
ywn	yawanawa	Yawanawa
ywq	wuding-luquan yi	Wuding-Luquan Yi
ywr	yawuru	Yawuru
ywt	xishanba lalo	Xishanba Lalo
ywu	wumeng nasu	Wumeng Nasu
yww	yawarawarga	Yawarawarga
yxa	mayawali	Mayawali
yxg	yagara	Yagara
yxl	yardliyawarra	Yardliyawarra
yxm	yinwum	Yinwum
yxu	yuyu	Yuyu
yxy	yabula yabula	Yabula Yabula
yyr	yir yoront	Yir Yoront
yyu	yau (sandaun province)	Yau (Sandaun Province)
yyz	ayizi	Ayizi
yzg	e'ma buyang	E'Ma Buyang
yzk	zokhuo	Zokhuo
zaa	sierra de juárez zapotec	Sierra De Juárez Zapotec
zab	western tlacolula valley zapotec	Western Tlacolula Valley Zapotec
zac	ocotlán zapotec	Ocotlán Zapotec
zad	cajonos zapotec	Cajonos Zapotec
zae	yareni zapotec	Yareni Zapotec
zaf	ayoquesco zapotec	Ayoquesco Zapotec
zag	zaghawa	Zaghawa
zah	zangwal	Zangwal
zai	isthmus zapotec	Isthmus Zapotec
zaj	zaramo	Zaramo
zak	zanaki	Zanaki
zal	zauzou	Zauzou
zam	miahuatlán zapotec	Miahuatlán Zapotec
zao	ozolotepec zapotec	Ozolotepec Zapotec
zap	zapotèque	Zapotèque
zaq	aloápam zapotec	Aloápam Zapotec
zar	rincón zapotec	Rincón Zapotec
zas	santo domingo albarradas zapotec	Santo Domingo Albarradas Zapotec
zat	tabaa zapotec	Tabaa Zapotec
zau	zangskari	Zangskari
zav	yatzachi zapotec	Yatzachi Zapotec
zaw	mitla zapotec	Mitla Zapotec
zax	xadani zapotec	Xadani Zapotec
zay	zayse-zergulla	Zayse-Zergulla
zaz	zari	Zari
zba	balaibalan	Balaibalan
zbc	central berawan	Central Berawan
zbe	east berawan	East Berawan
zbl	symboles Bliss ; Bliss	Symboles Bliss ; Bliss
zbt	batui	Batui
zbu	bu (bauchi state)	Bu (Bauchi State)
zbw	west berawan	West Berawan
zca	coatecas altas zapotec	Coatecas Altas Zapotec
zcd	las delicias zapotec	Las Delicias Zapotec
zch	central hongshuihe zhuang	Central Hongshuihe Zhuang
zdj	ngazidja comorian	Ngazidja Comorian
zea	zeeuws	Zeeuws
zeg	zenag	Zenag
zeh	eastern hongshuihe zhuang	Eastern Hongshuihe Zhuang
zen	zenaga	Zenaga
zga	kinga	Kinga
zgb	guibei zhuang	Guibei Zhuang
zgh	amazighe standard marocain	Amazighe Standard Marocain
zgm	minz zhuang	Minz Zhuang
zgn	guibian zhuang	Guibian Zhuang
zgr	magori	Magori
zha	zhuang ; chuang	Zhuang ; Chuang
zhb	zhaba	Zhaba
zhd	dai zhuang	Dai Zhuang
zhi	zhire	Zhire
zhn	nong zhuang	Nong Zhuang
zho	chinois	Chinois
zhw	zhoa	Zhoa
zia	zia	Zia
zib	zimbabwe sign language	Zimbabwe Sign Language
zik	zimakani	Zimakani
zil	zialo	Zialo
zim	mesme	Mesme
zin	zinza	Zinza
ziw	zigula	Zigula
ziz	zizilivakan	Zizilivakan
zka	kaimbulawa	Kaimbulawa
zkb	koibal	Koibal
zkd	kadu	Kadu
zkg	koguryo	Koguryo
zkh	khorezmian	Khorezmian
zkk	karankawa	Karankawa
zkn	kanan	Kanan
zko	kott	Kott
zkp	săo paulo kaingáng	Săo Paulo Kaingáng
zkr	zakhring	Zakhring
zkt	kitan	Kitan
zku	kaurna	Kaurna
zkv	krevinian	Krevinian
zkz	khazar	Khazar
zla	zula	Zula
zlj	liujiang zhuang	Liujiang Zhuang
zlm	malay (individual language)	Malay (Individual Language)
zln	lianshan zhuang	Lianshan Zhuang
zlq	liuqian zhuang	Liuqian Zhuang
zma	manda (australia)	Manda (Australia)
zmb	zimba	Zimba
zmc	margany	Margany
zmd	maridan	Maridan
zme	mangerr	Mangerr
zmf	mfinu	Mfinu
zmg	marti ke	Marti Ke
zmh	makolkol	Makolkol
zmi	negeri sembilan malay	Negeri Sembilan Malay
zmj	maridjabin	Maridjabin
zmk	mandandanyi	Mandandanyi
zml	matngala	Matngala
zmm	marimanindji	Marimanindji
zmn	mbangwe	Mbangwe
zmo	molo	Molo
zmp	mpuono	Mpuono
zmq	mituku	Mituku
zmr	maranunggu	Maranunggu
zms	mbesa	Mbesa
zmt	maringarr	Maringarr
zmu	muruwari	Muruwari
zmv	mbariman-gudhinma	Mbariman-Gudhinma
zmw	mbo (democratic republic of congo)	Mbo (Democratic Republic Of Congo)
zmx	bomitaba	Bomitaba
zmy	mariyedi	Mariyedi
zmz	mbandja	Mbandja
zna	zan gula	Zan Gula
znd	zandé, langues	Zandé, Langues
zne	zande (individual language)	Zande (Individual Language)
zng	mang	Mang
znk	manangkari	Manangkari
zns	mangas	Mangas
zoc	copainalá zoque	Copainalá Zoque
zoh	chimalapa zoque	Chimalapa Zoque
zom	zou	Zou
zoo	asunción mixtepec zapotec	Asunción Mixtepec Zapotec
zoq	tabasco zoque	Tabasco Zoque
zor	rayón zoque	Rayón Zoque
zos	francisco león zoque	Francisco León Zoque
zpa	lachiguiri zapotec	Lachiguiri Zapotec
zpb	yautepec zapotec	Yautepec Zapotec
zpc	choapan zapotec	Choapan Zapotec
zpd	southeastern ixtlán zapotec	Southeastern Ixtlán Zapotec
zpe	petapa zapotec	Petapa Zapotec
zpf	san pedro quiatoni zapotec	San Pedro Quiatoni Zapotec
zpg	guevea de humboldt zapotec	Guevea De Humboldt Zapotec
zph	totomachapan zapotec	Totomachapan Zapotec
zpi	santa maría quiegolani zapotec	Santa María Quiegolani Zapotec
zpj	quiavicuzas zapotec	Quiavicuzas Zapotec
zpk	tlacolulita zapotec	Tlacolulita Zapotec
zpl	lachixío zapotec	Lachixío Zapotec
zpm	mixtepec zapotec	Mixtepec Zapotec
zpn	santa inés yatzechi zapotec	Santa Inés Yatzechi Zapotec
zpo	amatlán zapotec	Amatlán Zapotec
zpp	el alto zapotec	El Alto Zapotec
zpq	zoogocho zapotec	Zoogocho Zapotec
zpr	santiago xanica zapotec	Santiago Xanica Zapotec
zps	coatlán zapotec	Coatlán Zapotec
zpt	san vicente coatlán zapotec	San Vicente Coatlán Zapotec
zpu	yalálag zapotec	Yalálag Zapotec
zpv	chichicapan zapotec	Chichicapan Zapotec
zpw	zaniza zapotec	Zaniza Zapotec
zpx	san baltazar loxicha zapotec	San Baltazar Loxicha Zapotec
zpy	mazaltepec zapotec	Mazaltepec Zapotec
zpz	texmelucan zapotec	Texmelucan Zapotec
zqe	qiubei zhuang	Qiubei Zhuang
zra	kara (korea)	Kara (Korea)
zrg	mirgan	Mirgan
zrn	zerenkel	Zerenkel
zro	záparo	Záparo
zrp	zarphatic	Zarphatic
zrs	mairasi	Mairasi
zsa	sarasira	Sarasira
zsk	kaskean	Kaskean
zsl	zambian sign language	Zambian Sign Language
zsm	standard malay	Standard Malay
zsr	southern rincon zapotec	Southern Rincon Zapotec
zsu	sukurum	Sukurum
zte	elotepec zapotec	Elotepec Zapotec
ztg	xanaguía zapotec	Xanaguía Zapotec
ztl	lapaguía-guivini zapotec	Lapaguía-Guivini Zapotec
ztm	san agustín mixtepec zapotec	San Agustín Mixtepec Zapotec
ztn	santa catarina albarradas zapotec	Santa Catarina Albarradas Zapotec
ztp	loxicha zapotec	Loxicha Zapotec
ztq	quioquitani-quierí zapotec	Quioquitani-Quierí Zapotec
zts	tilquiapan zapotec	Tilquiapan Zapotec
ztt	tejalapan zapotec	Tejalapan Zapotec
ztu	güilá zapotec	Güilá Zapotec
ztx	zaachila zapotec	Zaachila Zapotec
zty	yatee zapotec	Yatee Zapotec
zua	zeem	Zeem
zuh	tokano	Tokano
zul	zoulou	Zoulou
zum	kumzari	Kumzari
zun	zuni	Zuni
zuy	zumaya	Zumaya
zwa	zay	Zay
zxx	pas de contenu linguistique	Pas De Contenu Linguistique
zyb	yongbei zhuang	Yongbei Zhuang
zyg	yang zhuang	Yang Zhuang
zyj	youjiang zhuang	Youjiang Zhuang
zyn	yongnan zhuang	Yongnan Zhuang
zyp	zyphe chin	Zyphe Chin
zza	zaza; dimili; dimli; kirdki; kirmanjki; zazaki	Zaza; Dimili; Dimli; Kirdki; Kirmanjki; Zazaki
zzj	zuojiang zhuang	Zuojiang Zhuang